Aba	K
Abaca	K
Abacan	K
Abaç	K
Abay	E
Abayhan	E
Abaza	K
Abbas	E
Abdal	E
Abdi	E
Abdullah	E
Abdurrahman	E
Abdülâlim	E
Abdülazim	E
Abdülaziz	E
Abdülbaki	E
Abdülbari	E
Abdülbasir	E
Abdülbasit	E
Abdülcabbar	E
Abdülcebbar	E
Abdülcelil	E
Abdülcemal	E
Abdülcevat	E
Abdülezel	E
Abdülferit	E
Abdülfettah	E
Abdülgaffar	E
Abdülgaffur	E
Abdülgafur	E
Abdülgani	E
Abdülhadi	E
Abdülhak	E
Abdülhakim	E
Abdülhalik	E
Abdülhalim	E
Abdülhamit	E
Abdülkadir	E
Abdülkahhar	E
Abdülkerim	E
Abdüllâtif	E
Abdülmecit	E
Abdülmelik	E
Abdülmennan	E
Abdülmetin	E
Abdülnasir	E
Abdülvahap	E
Abdülvahit	E
Abdürrahim	E
Abdürrahman	E
Abdürrauf	E
Abdürresit	E
Abdürrezzak	E
Abdüssamet	E
Abdüssami	E
Abdüsselâm	E
Abdüssemi	E
Abdüssettar	E
Abdüzzeki	E
Abgül	K
Abher	K
Abihayat	K
Abir	E
Abiru	K
Abid	E
Abide	K
Abidin	E
Abil	E
Abir	E
Abit	E
Abiye	K
Ablak	E
Abras	E
Abruy	K
Abuska	E
Abuzer	E
Abuzettin	E
Acabay	E
Acabey	E
Agabay	E
Agcabey	E
Akabay	E
Akabey	E
Akçabay	E
Alabas	E
Alabay	E
Alabegim	K
Alabegüm	K
Alabezek	K
Almabanu	K
Anabaci	K
Anabörü	K
Atabay	E
Atabek	E
Atabey	E
Atabörü	E
Ayaba	K
Babacan	E
Babaç	E
Babayigit	E
Babür	E
Babürsah	E
Balaban	E
Cabbar	E
Cabir	E
Çaba	E
Çabar	E
Farabi	E
Gültab	K
Hicabi	E
Isabet	K
Kabadayi	E
Kaban	E
Kabil	E
Kamertab	K
Karabas	E
Karabatak	E
Karabay	E
Karabet	E
Karabey	E
Karaboga	E
Karabörü	E
Karabudun	E
Karabugday	E
Karabugra	E
Karabulut	E
Karabükey	E
Karacabey	E
Kayrabay	E
Kocabas	E
Kocabey	E
Mehabet	K
Muhabbet	K
Nabi	E
Nabia	K
Nabiye	K
Necabet	E
Necabettin	E
Nursabah	K
Nusabe	K
Olcabay	E
Rabbani	E
Rabi	E
Rabia	K
Rabih	E
Saba	U
Sabah	U
Sabahat	K
Sabahattin	E
Sabahnur	K
Sabar	E
Sabbar	U
Sabika	K
Sabir	K
Sabih	E
Sabiha	K
Sabir	U
Sabire	K
Sabit	E
Sabite	K
Sabiye	K
Sabri	E
Sabrinnisa	K
Sabriye	K
Sabur	E
Sabutay	E
Sahabi	E
Saricabay	E
Saban	E
Sahabettin	E
Tabende	K
Tabgaç	E
Türabi	E
Yabalak	E
Yaban	E
Yabar	E
Yabgu	E
Yabiz	E
Yalabuk	E
Yalazabay	E
Zabit	E
Zeynelabidin	E
Aca	E
Acahan	E
Acar	U
Acaralp	E
Acarbegüm	K
Acarbey	E
Acarbike	K
Acarbüke	K
Acarer	E
Acarhatun	K
Acarkan	U
Acarkatun	K
Acarman	E
Acaröz	E
Acarsoy	E
Acartürk	E
Acatay	E
Acidas	E
Aclan	E
Acun	E
Acunal	E
Acunalan	E
Acunalp	E
Acunbegim	K
Acunbegüm	K
Acunbike	K
Acunbüke	K
Acuner	E
Acungünes	K
Acunisik	K
Acunman	E
Acunseven	E
Aça	K
Açalya	K
Açangül	K
Açelya	K
Açikalin	E
Açikel	E
Açiker	E
Açikgün	E
Açil	E
Açilay	K
Açine	E
Açkingül	K
Adahan	E
Adak	U
Adal	U
Adalan	E
Adalet	K
Adalettin	E
Adam	E
Adamis	E
Adanan	E
Adanir	U
Adar	U
Adarkan	E
Adasal	E
Adas	E
Aday	E
Adeviye	K
Adibelli	U
Adigün	E
Adigüzel	U
Adin	E
Adisanli	E
Adisönmez	E
Adisah	K
Adivar	E
Adiyahsi	E
Adiyaman	E
Adil	E
Adile	K
Adilhan	E
Adlan	E
Adli	E
Adlig	E
Adli	E
Adnan	E
Adni	E
Adniye	K
Adsiz	E
Adsoy	E
Adviye	K
Afacan	E
Afak	U
Afer	E
Afet	K
Affan	U
Afi	K
Afif	E
Afife	K
Afitap	K
Afiye	K
Afiyet	K
Afra	K
Afsar	E
Afsin	E
Agâh	E
Agil	E
Agus	K
Aga	E
Agacan	E
Agahan	E
Agahanim	K
Agahatun	K
Agakan	E
Agakatun	K
Agan	U
Aganbegim	K
Aganbegüm	K
Aganbike	K
Aganbüke	K
Aganer	E
Agaoglu	E
Agar	E
Agarantan	E
Agaverdi	E
Agbaci	K
Agbegim	K
Agbegüm	K
Agbet	K
Agbilek	K
Agca	U
Agça	K
Agçelik	E
Ager	E
Aggül	K
Agin	E
Agirtas	E
Agis	U
Agkiz	K
Agnak	E
Agyar	E
Ahen	E
Ahenk	K
Ahfes	E
Ahiska	E
Ahi	E
Ahmet	E
Ahsen	U
Ahter	U
Ahu	K
Aise	K
Ajda	K
Ajlan	E
Ak	K
Aka	E
Akad	E
Akadli	E
Akagan	E
Akal	E
Akalan	E
Akalin	U
Akalp	E
Akaltan	E
Akan	E
Akanay	U
Akaner	E
Akansu	E
Akant	E
Akanyildiz	E
Akarca	E
Akarçay	E
Akarsel	E
Akarsu	U
Akartuna	E
Akartürk	E
Akasma	E
Akasoy	E
Akata	E
Akatay	E
Akay	U
Akaydin	E
Akbaci	K
Akbal	U
Akbaran	E
Akbas	E
Akbasak	U
Akbatu	E
Akbatur	E
Akbay	E
Akbayar	E
Akbek	E
Akbel	E
Akbet	E
Akbey	E
Akbil	E
Akbilge	E
Akboga	E
Akbora	E
Akboy	E
Akbörü	E
Akbudun	E
Akbug	E
Akbulut	E
Akburak	E
Akburç	E
Akburçak	E
Akcan	U
Akcebe	E
Akcivan	E
Akça	U
Akçael	E
Akçagül	K
Akçakan	E
Akçakaya	E
Akçakil	E
Akçakoca	E
Akçal	E
Akçali	E
Akçam	E
Akçan	E
Akçasu	U
Akçay	E
Akçer	E
Akçigir	E
Akçil	U
Akçinar	E
Akçiçek	K
Akçit	E
Akçora	E
Akdag	E
Akdal	E
Akdamar	E
Akdemir	E
Akdeniz	E
Akdes	U
Akdik	E
Akdiken	E
Akdil	E
Akdog	E
Akdogan	E
Akdogdu	E
Akdogmus	E
Akdogu	E
Akdolun	K
Akdora	E
Akdoru	E
Akdoruk	E
Akdöl	E
Akduman	E
Akdur	E
Akdurmus	E
Akel	U
Aker	E
Akergin	E
Akerman	E
Akersan	E
Akersoy	E
Akgil	E
Akgiray	E
Akgöl	E
Akgöze	E
Akgüç	E
Akgül	K
Akgün	E
Akgündüz	E
Akgüner	E
Akgünes	U
Akgüngör	U
Akhan	E
Akhanim	K
Akhun	E
Aki	E
Akialp	E
Akil	E
Akilbek	E
Akilli	E
Akiman	E
Akin	E
Akinal	E
Akinalp	E
Akinci	E
Akincibay	E
Akiner	E
Akineri	E
Akintan	E
Akibe	K
Akide	K
Akif	E
Akife	K
Akil	E
Akile	K
Akinci	K
Akip	E
Akipek	K
Akkadin	K
Akkan	E
Akkar	K
Akkas	E
Akkaya	E
Akkaynak	E
Akkemik	E
Akkerman	E
Akkiliç	E
Akkin	E
Akkiz	K
Akkor	K
Akköz	E
Akkurt	E
Akkus	E
Akkutlu	K
Akkuyas	E
Aklan	E
Akmaç	E
Akman	E
Akmanalp	E
Akmaner	E
Akmaral	K
Akmeriç	E
Aknur	K
Akol	K
Akozan	E
Akönder	E
Akören	E
Aköz	E
Akpay	E
Akpinar	U
Akpolat	E
Akpulat	E
Aksal	E
Aksan	E
Aksari	K
Aksay	E
Aksel	U
Aksen	K
Akser	E
Akses	U
Akseven	K
Aksevil	K
Aksin	U
Aksoy	U
Aksögüt	E
Aksu	U
Aksun	E
Aksuna	K
Aksunar	E
Aksuner	E
Aksungur	E
Aksülün	K
Aksüyek	U
Aksin	E
Aksit	E
Aktaç	U
Aktalay	E
Aktan	E
Aktar	E
Aktas	E
Aktay	E
Aktekin	E
Aktemür	E
Akti	E
Aktimur	E
Aktolga	E
Aktolun	K
Aktug	E
Aktuna	U
Aktunç	E
Aktün	E
Aktürk	E
Akün	U
Akünal	E
Akvarol	E
Akyel	E
Akyildiz	U
Akyigit	E
Akyipek	K
Akyol	E
Akyön	E
Akyurt	E
Akyürek	E
Akyüz	E
Ala	U
Alâaddin	E
Alaca	E
Alacan	E
Alaçam	E
Alaçuk	E
Aladogan	E
Alageyik	K
Alagöz	K
Alagün	K
Alahan	E
Alakiz	K
Alakoç	E
Alakurt	E
Alakus	U
Alâmet	E
Alan	E
Alanalp	E
Alanay	E
Alanbay	E
Alaner	E
Alangoya	K
Alangu	E
Alanur	K
Alapinar	K
Alat	E
Alatan	E
Alatas	E
Alatay	E
Alay	E
Alaybey	E
Alayunt	K
Alaz	U
Albayrak	E
Albeni	K
Albora	E
Alburak	E
Alcan	E
Alçik	E
Alçin	E
Alçinsu	E
Alçiçek	K
Alçin	K
Aldemir	E
Aldeniz	K
Aldogan	E
Alem	E
Alemdar	E
Alemsah	K
Âlemsah	U
Âlemtap	K
Alev	K
Alevnaz	K
Algan	E
Algin	E
Algis	K
Algu	E
Algun	E
Algur	E
Algül	K
Algün	U
Alhan	E
Alici 	E
Alim	K
Alimli	K
Alincak	K
Alisik	U
Alisin	K
Ali	E
Alican	E
Alihan	E
Alika	K
Alim	E
Alime	K
Alipek	K
Alisa	K
Alise	K
Alis	E
Alisah	E
Alisan	E
Aliyar	E
Aliye	K
Alkan	U
Alkas	E
Alkiliç	E
Alkim	U
Alkin	E
Alkis	E
Alkoç	E
Alkor	U
Alköz	K
Alkun	E
Allahverdi	E
Alli	K
Allikiz	K
Almagül	K
Almila	U
Almila	K
Almile	K
Almula	K
Alnar	E
Alniaçik	E
Alniak	E
Alp	E
Alpagu	E
Alpagan	E
Alpak	E
Alpar	E
Alparslan	E
Alpartun	E
Alpaslan	E
Alpat	E
Alpata	E
Alpay	E
Alpaydin	E
Alpayer	E
Alpbilge	E
Alpçetin	E
Alpdemir	E
Alpdogan	E
Alper	E
Alperen	E
Alpergin	E
Alpermis	E
Alpertunga	E
Alpgiray	E
Alphan	E
Alpkan	E
Alpkanat	E
Alpkartal	E
Alpkin	E
Alpkutlu	E
Alpkülük	E
Alpman	E
Alpnur	K
Alpogan	E
Alpsoy	E
Alpsü	E
Alptekin	E
Alptogan	E
Alptug	E
Alpyürek	E
Alpyürük	E
Alsan	U
Alsancak	E
Alsevin	K
Alsoy	U
Alsu	K
Altaç	U
Altan	U
Altaner	E
Altas	E
Altav	E
Altay	E
Altemür	E
Alten	E
Altin	U
Altinay	U
Altinbaran	E
Altinbas	E
Altinbasak	K
Altinbay	E
Altinbike	K
Altinçiçek	K
Altindal	K
Altinel	E
Altiner	E
Altingül	K
Altinhan	E
Altinhanim	K
Altinhatun	K
Altinisik	U
Altinisin	U
Altiniz	U
Altinkaya	E
Altinkiliç	E
Altinkiz	K
Altinnur	K
Altinok	E
Altinöz	E
Altinsaç	K
Altinsoy	E
Altintaç	U
Altintas	E
Altintop	E
Altintug	E
Altogan	E
Altop	E
Altug	E
Altun	E
Altuna	E
Altunay	E
Altunbas	E
Altuncan	K
Altunç	E
Altunçag	E
Altuner	E
Altunhan	E
Altuntas	E
Alyipek	K
Amaç	E
Amanullah	E
Amber	K
Amil	E
Amile	K
Amine	K
Amir	E
Amiran	K
Amire	K
Amre	K
Anadolu	E
Anahanim	K
Anakadin	K
Anakiz	K
Anar	K
Anargül	K
Anber	K
Anci	E
Ançibay	E
Andaç	U
Andak	E
Andelip	U
Andiç	E
Andiç	E
Angi	E
Angil	E
Angin	U
Angis	E
Angit	E
Ani	E
Anik	E
Anil	U
Anit	E
Anka	K
Anli	E
Annak	E
Ant	E
Apa	E
Apak	E
Apakhan	E
Apaydin	E
Araci	E
Arafat	E
Aral	U
Aran	U
Aras	E
Arat	E
Araz	U
Arbas	E
Arbay	E
Arbek	E
Arca	E
Arcan	E
Arda	U
Ardahan	E
Ardemir	E
Ardiç	E
Ardil	E
Arefe	K
Arel	E
Arer	E
Argana	K
Argin	E
Argu	E
Arguç	E
Argüden	E
Argüder	E
Argün	E
Arhan	E
Ari	U
Aribal	E
Aribas	E
Ariboga	E
Arica	E
Arican	U
Ariç	U
Ariel	U
Arier	E
Arig	E
Arihan	E
Arik	E
Arikal	E
Arikan	E
Arikboga	E
Ariker	E
Arikhan	E
Arikiz	E
Arikol	E
Arikut	E
Aril	E
Ariman	E
Arin	U
Arinç	U
Arinik	E
Aripinar	U
Arisal	E
Arisan	E
Arisoy	E
Arisu	U
Aris	E
Aritan	E
Aritas	E
Ariyüz	E
Ari	E
Arif	E
Arife	K
Arik	E
Arkadas	E
Arkan	E
Arkay	K
Arkin	U
Arkis	E
Arkoç	E
Arkun	E
Arkut	E
Arlan	E
Armagan	U
Arman	U
Armanç	K
Arna	E
Arol	E
Arpad	E
Arpag	E
Arpak	E
Arpinar	E
Arsal	U
Arsan	E
Arslan	E
Arslaner	E
Arsoy	E
Artaç	E
Artam	E
Artan	E
Artik	E
Artuç	E
Artuk	E
Artun	E
Artunç	E
Artut	E
Aru	U
Arukan	E
Arukiz	K
Aryüz	E
Arzik	E
Arziye	K
Arzu	K
Arzugül	K
Arzuhan	K
Arzum	K
Asaf	E
Asal	E
Asalbegim	K
Asalbegüm	K
Asalet	U
Asan	E
Âsan	K
Asena	K
Asfer	K
Asi	E
Asif	E
Asilbanu	K
Asilgül	K
Asim	E
Asima	K
Asil	E
Asile	K
Asime	K
Asimegül	K
Asiye	K
Aslan	E
Aslaner	E
Aslanhan	E
Asli	K
Aslibey	E
Asligül	K
Aslihan	U
Aslim	K
Aslinur	K
Asliye	K
Asma	K
Asri	E
Asu	U
Asude	K
Asuman	K
Asutay	E
Asya	K
Asye	K
Asa	K
Asan	E
Ascir	E
Asir	E
Asina	K
Asir	E
Askan	E
Askim	K
Askin	U
Askinay	E
Askiner	E
Ata	E
Atâ	E
Ataan	E
Atacan	E
Ataç	E
Atadan	E
Ataergin	E
Atagül	K
Atagün	E
Atahan	E
Atak	E
Atakan	E
Ataker	E
Atakul	E
Atakurt	E
Atakut	E
Atalan	E
Atalay	E
Atalmis	E
Ataman	E
Atambay	E
Atamer	E
Atamtürk	E
Ataner	E
Atanur	U
Ataol	E
Ataöv	E
Atasagun	E
Atasan	E
Atasay	E
Atasev	E
Ataseven	E
Atasever	E
Atasevin	E
Atasoy	E
Atasü	E
Atatöre	E
Atatug	E
Atatüre	E
Atatürk	E
Ataullah	E
Ataün	E
Atay	E
Ates	E
Atfi	E
Atgun	E
Atif	E
Atifa	K
Atife	K
Atil	E
Atilay	U
Atilgan	E
Atiz	E
Atik	E
Atila	E
Atilla	E
Atime	K
Atiye	K
Atlan	E
Atlas	K
Atli	E
Atlig	E
Atlihan	E
Atmaca	E
Atom	E
Attilâ	E
Atuf	E
Avar	E
Avci	E
Avhan	E
Avkan	E
Avni	E
Avniye	K
Avsar	E
Avunç	U
Ay	U
Aya	K
Ayaça	K
Ayal	K
Ayalp	E
Ayaltin	U
Ayana	K
Ayanç	E
Ayanfer	K
Ayas	U
Ayasun	K
Ayasan	K
Ayata	E
Ayataç	U
Ayaydin	E
Ayaz	E
Aybala	K
Aybanu	K
Aybar	E
Aybars	E
Aybas	E
Aybay	E
Aybegim	K
Aybegüm	K
Aybek	E
Ayben	K
Aybeniz	K
Ayberk	E
Aybet	K
Aybey	E
Aybige	K
Aybike	K
Aybir	K
Aybirgen	K
Ayboga	E
Aybora	E
Aybüge	K
Aybüke	K
Ayca	K
Aycagül	K
Aycahan	K
Aycan	U
Aycennet	K
Ayceren	K
Aycil	E
Aycihan	E
Ayça	K
Ayçag	K
Ayçetin	E
Ayçil	K
Ayçiçek	K
Ayçil	K
Ayçolpan	K
Ayçulpan	K
Ayda	K
Aydagül	K
Aydan	K
Aydanari	K
Aydanur	K
Aydar	U
Aydemir	E
Aydeniz	U
Aydenk	K
Aydin	U
Aydinalp	E
Aydinay	U
Aydinbay	E
Aydinbey	E
Aydinel	E
Aydiner	E
Aydinol	E
Aydintan	E
Aydintug	E
Aydinyol	E
Aydil	K
Aydilek	K
Aydinç	U
Aydogan	U
Aydogdu	E
Aydogmus	E
Aydolu	K
Aydolun	U
Aydonat	E
Ayduru	K
Ayet	E
Ayetullah	E
Ayfer	K
Ayferi	K
Ayferim	K
Aygen	K
Aygerim	K
Aygök	K
Aygöl	K
Aygönenç	K
Aygönül	K
Aygut	E
Aygutalp	E
Aygül	K
Aygüler	K
Aygülhan	K
Aygümüs	K
Aygün	U
Aygüner	E
Aygünkiz	K
Aygür	K
Aygüzel	K
Ayhan	U
Ayhanim	K
Ayhatun	K
Ayik	E
Ayim	K
Ayimbet	K
Ayimsa	K
Ayisigi	K
Ayisini	K
Ayilkin	K
Aykaç	E
Aykal	U
Aykan	U
Aykas	K
Aykatun	K
Aykin	E
Aykiz	K
Aykönül	K
Aykul	E
Aykurt	E
Aykut	U
Aykutalp	E
Aykutlu	E
Aykün	K
Ayla	K
Aylan	U
Aylanur	K
Aylin	K
Ayman	E
Aymaral	K
Aymelek	K
Aymete	E
Aymutlu	E
Ayna	K
Aynagül	K
Aynifer	K
Aynimah	K
Ayni	E
Aynisa	K
Aynisah	K
Ayniye	K
Aynur	K
Aypar	E
Aypare	K
Aypars	E
Ayperi	K
Aypinar	K
Aypolat	E
Ayral	U
Ayril	E
Aysal	U
Aysan	U
Aysel	K
Ayselen	K
Aysema	K
Aysen	K
Ayser	K
Aysere	K
Ayseren	K
Aysev	U
Ayseven	K
Aysever	E
Aysevil	K
Aysevim	K
Aysevin	E
Aysilu	K
Aysin	U
Aysim	K
Aysima	K
Aysine	K
Aysoy	U
Aysu	U
Aysuda	K
Aysultan	K
Aysun	U
Aysuna	K
Aysunar	U
Aysunay	K
Aysungur	E
Aysü	E
Aysan	U
Ayse	K
Aysecan	K
Aysedudu	K
Aysegül	K
Aysehan	K
Aysen	K
Aysenur	K
Aysil	K
Aysin	K
Aysim	K
Aysin	K
Aysirin	K
Aysöhret	K
Aytaç	U
Aytan	U
Aytar	E
Aytek	U
Aytekin	E
Aytemiz	U
Aytemur	E
Ayten	K
Ayterim	K
Aytis	E
Aytigin	E
Aytimur	E
Aytirim	K
Aytok	E
Aytolun	U
Aytop	U
Aytöre	U
Aytöz	K
Aytug	U
Aytuna	U
Aytunca	E
Aytunç	E
Aytunga	E
Aytutkun	K
Aytül	K
Aytün	U
Aytürk	U
Ayulduz	K
Ayülger	K
Ayülker	K
Ayün	E
Ayvaz	E
Ayver	K
Ayverdi	U
Ayyalap	K
Ayyalin	K
Ayyarkin	U
Ayyaruk	U
Ayyildiz	U
Ayyuca	K
Ayyüce	U
Ayyüz	K
Ayzit	K
Ayzühre	K
Azade	K
Azadi	E
Azam	E
Azamet	E
Azamettin	E
Azat	E
Azelya	K
Azer	U
Azim	E
Azime	K
Aziz	E
Azize	K
Azmi	E
Azmidil	K
Azmun	E
Aznavur	E
Azra	K
Azrak	E
Azze	K
Baci	K
Bade	K
Badegül	K
Badiye	K
Bagatur	E
Bagdaç	E
Bagdagül	K
Bagdas	E
Bagir	E
Bagis	E
Bagishan	E
Baglan	K
Baha	E
Bahadir	E
Bahadirhan	E
Bahai	E
Bahar	K
Bahattin	E
Bahir	E
Bahise	K
Bahri	E
Bahriye	K
Bahsi	E
Bahtinur	K
Bahtiser	K
Bahtisen	K
Bahti	E
Bahtiyar	U
Bakanay	U
Bakir	E
Bakirhan	E
Baki	E
Bakinaz	K
Bakiye	K
Baksi	E
Bala	E
Balâ	E
Balâbey	E
Balaman	E
Balamir	E
Balatekin	E
Balatürk	E
Balaz	E
Balbal	E
Balbay	E
Balbey	E
Balca	K
Balcan	E
Baldan	K
Baldemir	E
Baler	E
Balhan	E
Bali	E
Balibas	E
Balibey	E
Balim	U
Balin	K
Balibey	E
Balk	E
Balkan	E
Balki	U
Balkin	K
Balkir	U
Balkis	E
Balkiz	K
Balkoç	E
Balli	K
Balsan	E
Balsari	K
Balseker	K
Baltas	E
Bandak	E
Bangu	E
Banu	K
Banuhan	K
Barak	E
Baran	E
Baranalp	E
Baranbilge	E
Baransel	E
Baray	E
Barbaros	E
Barça	E
Barçak	E
Barçin	U
Barim	E
Barin	E
Baris	U
Bariscan	E
Baria	K
Barik	E
Barika	K
Bariz	E
Barkan	E
Barkin	U
Barlas	E
Barlik	E
Bars	E
Barsbay	E
Barsbey	E
Bartu	E
Basa	E
Basak	E
Basim	E
Basira	K
Basir	E
Basiret	K
Baskak	E
Baskan	E
Baskin	E
Basri	E
Basriye	K
Basut	E
Basaga	E
Basak	K
Basal	E
Basar	U
Basargan	E
Basarman	E
Basat	E
Basay	U
Basaydin	E
Basbay	E
Basbug	E
Basçik	K
Basdemir	E
Basdogan	E
Basegmez	E
Basel	E
Baser	E
Bashan	E
Baskal	E
Baskan	E
Baskara	E
Baskaya	E
Baskaynak	E
Baskur	E
Baskurt	E
Baskut	E
Basman	E
Basok	E
Basol	E
Basöz	E
Bassoy	E
Bastas	E
Bastemir	E
Bastugay	E
Bastug	E
Bastürk	E
Bati	U
Batibay	E
Batibey	E
Batican	E
Batihan	E
Batir	E
Batiray	E
Batirhan	E
Battal	E
Batu	E
Batucem	E
Batuhan	E
Batur	E
Baturalp	E
Baturay	E
Baturhan	E
Bayar	E
Baybars	E
Baybas	E
Baybek	E
Baybora	E
Baybörü	E
Baycan	E
Bayça	E
Baydogan	E
Baydu	E
Baydur	E
Bayduralp	E
Bayer	E
Bayezit	E
Baygüç	E
Bayhan	E
Bayhun	E
Bayik	E
Bayin	E
Bayindir	E
Bayir	E
Bayirhan	E
Baykal	E
Baykam	E
Baykan	E
Baykara	E
Baykir	E
Baykoca	E
Baykor	E
Baykul	E
Baykurt	E
Baykut	E
Baykutay	E
Baylan	U
Bayman	E
Bayol	E
Bayrak	E
Bayraktar	E
Bayram	E
Bayri	E
Bayru	E
Bayrualp	E
Bayrubay	E
Bayruhan	E
Bayruk	E
Baysal	U
Baysan	E
Baysoy	E
Baysu	E
Baysungur	E
Baytal	E
Baytas	E
Baytekin	E
Baytimur	E
Baytok	E
Baytugay	E
Baytüze	E
Baytüzün	E
Bayuk	E
Bayülken	E
Bayyigit	E
Bedia	K
Bedirhan	E
Bedirnisa	K
Bedreka	K
Behnan	E
Behnane	K
Behram	E
Behzat	E
Bekata	E
Bekbars	E
Bekbay	E
Beksan	E
Bektas	E
Beleda	E
Bellisan	E
Belma	K
Benal	E
Benam	E
Benan	U
Benay	K
Benazir	E
Bengialp	E
Bengibay	E
Bengisan	U
Bengitas	E
Bengühan	K
Benian	K
Berat	U
Bergüzar	K
Beria	K
Berkal	E
Berkan	E
Berkant	E
Berkay	E
Berkkan	E
Berkman	E
Berksal	E
Berksan	E
Berksay	E
Berktan	E
Berna	U
Berrak	K
Berran	U
Bertan	E
Besalet	U
Besamet	K
Besat	E
Besaret	U
Besarettin	E
Betülay	K
Beyaz	K
Beyazit	E
Beybars	E
Beybolat	E
Beycan	E
Beyda	E
Beydag	E
Beydas	E
Beyhan	U
Beyhatun	K
Beykal	E
Beykan	E
Beykara	E
Beylan	K
Beysan	E
Beytullah	E
Beyza	K
Beyzade	E
Beyzat	E
Bican	E
Bidar	K
Bidayet	K
Bihan	K
Bilan	E
Bilay	U
Bilbasar	E
Bilbay	E
Bileda	E
Bilgealp	E
Bilgebay	E
Bilgecan	K
Bilgehan	U
Bilgekagan	E
Bilgekan	E
Bilgetay	E
Bilgihan	E
Bilgivar	K
Bilgütay	E
Bilhan	U
Bilkan	E
Bilsay	E
Biltas	E
Biltay	E
Bilyap	E
Binal	E
Binali	E
Binalp	E
Binan	E
Binat	E
Binay	U
Binbasar	E
Binbay	E
Bindal	E
Binhan	K
Binkan	E
Binnaz	K
Binyasar	E
Biran	E
Birant	E
Biray	U
Bircan	U
Birdal	U
Birhan	U
Birkan	E
Birnaz	K
Birsan	U
Birtan	E
Birtane	K
Boga	E
Bogaç	E
Bogaçhan	E
Bogahan	E
Bogatas	E
Bogatay	E
Bogatekin	E
Bogatir	E
Bogatimur	E
Bolat	E
Bolcan	E
Bolgan	E
Bolhan	E
Bolkan	E
Bora	E
Borahan	E
Borak	E
Borakan	E
Borakhan	E
Boran	E
Boranalp	E
Boranbay	E
Boransü	E
Boratas	E
Boratav	E
Boratay	E
Boray	E
Borkan	E
Boyar	E
Boydak	E
Boydas	E
Boylan	E
Boynak	E
Boyraz	E
Boysal	E
Boysan	E
Bozan	E
Bozat	E
Bozay	E
Bozbag	E
Bozbala	E
Bozbas	E
Bozbay	E
Bozbora	E
Bozca	E
Bozdag	E
Bozdogan	E
Bozhan	E
Bozkan	E
Bozkara	E
Bozkaya	E
Bozlak	E
Bozokay	E
Boztas	E
Bölükbasi	E
Börübars	E
Börübay	E
Börühan	E
Börükan	E
Bucak	E
Budak	E
Budunal	E
Budunalp	E
Bugday	K
Bugra	E
Bugrahan	E
Bukay	E
Bulak	E
Bulgan	E
Bulgubay	E
Bulgucan	E
Bulgunoyan	E
Bulutay	E
Buminhan	E
Burak	E
Burçak	U
Burçhan	E
Burhan	E
Burhanettin	E
Burkay	E
Burukbay	E
Buyan	E
Buyrukalp	E
Buyrukata	E
Buyrukbay	E
Buyrukhan	E
Bükay	E
Büldan	K
Bünyamin	E
Büran	E
Bürkan	U
Bürran	K
Büsra	K
Cafer	E
Cahide	K
Cahit	E
Caize	K
Calibe	K
Calp	E
Can	U
Cana	K
Canal	U
Canalp	E
Canaltay	E
Canan	U
Canane	K
Canas	K
Canat	E
Canay	U
Canaydin	E
Canbay	E
Canbek	E
Canberk	E
Canbey	E
Canbolat	E
Canbulat	E
Canda	E
Candan	U
Candaner	E
Candar	E
Candas	U
Candeger	U
Candemir	E
Candogan	E
Canel	U
Caner	E
Canfeda	K
Canfer	E
Canfes	K
Canfeza	K
Canfidan	K
Canfide	K
Cangiray	E
Cangül	K
Cangün	U
Cangür	E
Canhanim	K
Canipek	K
Canik	K
Canip	E
Canipek	K
Cankan	E
Cankat	U
Cankaya	E
Cankiliç	E
Cankiz	K
Cankoç	E
Cankorur	E
Cankurt	E
Cankut	E
Cannur	U
Canol	E
Canören	E
Canöz	U
Canözen	K
Canözlem	K
Canperver	K
Canpolat	E
Canrüba	K
Cansal	E
Cansay	E
Cansel	U
Cansen	U
Canser	U
Canses	K
Cansev	K
Canseven	U
Cansever	U
Cansin	U
Cansoy	U
Cansu	U
Cansun	U
Cansunar	U
Cansunay	E
Cansuner	E
Cantas	E
Cantekin	E
Canten	K
Cantez	E
Cantürk	E
Canyurt	E
Caran	E
Carim	E
Carullah	E
Cavidan	K
Cavit	E
Cavli	E
Cavuldur	E
Caymaz	E
Cazibe	K
Cazim	E
Cazip	E
Cebbar	E
Cebealp	E
Cebrail	E
Cefa	E
Celilay	E
Cemal	E
Cemaleddin	E
Cemalettin	E
Cemalullah	E
Cemsah	E
Cenan	E
Cenani	E
Cenap	E
Cengizhan	E
Cerullah	E
Cevahir	U
Cevat	E
Cevval	U
Cevza	K
Ceyda	K
Ceydahan	K
Ceyhan	U
Cezayir	E
Cihan	U
Cihanbanu	K
Cihandar	E
Cihandide	E
Cihanefruz	E
Cihaner	E
Cihanfer	K
Cihangir	E
Cihangül	K
Cihani	E
Cihanmert	E
Cihannur	U
Cihansah	E
Cihat	E
Cilvenaz	K
Cilvesaz	K
Civan	E
Civanbaht	E
Civanmert	E
Civansir	E
Cosan	E
Cosar	E
Coskunay	E
Cuma	E
Cumali	E
Cura	E
Cündullah	E
Çadir	E
Çag	E
Çaga	E
Çagaçan	E
Çagaçar	E
Çagakan	E
Çagan	E
Çaganak	E
Çagatay	E
Çagay	E
Çagbay	E
Çagdas	U
Çagil	U
Çagilti	E
Çagin	U
Çagir	E
Çagkan	E
Çagla	U
Çaglak	U
Çaglam	E
Çaglan	E
Çaglar	U
Çaglasin	U
Çaglayan	U
Çaglayangil	E
Çaglayantürk	E
Çagli	E
Çagman	E
Çagnur	K
Çagri	U
Çagribey	E
Çagrinur	K
Çagveren	E
Çakan	E
Çakar	E
Çakil	E
Çakim	E
Çakin	E
Çakir	U
Çakirbey	E
Çakirca	E
Çakirer	E
Çakmak	E
Çakman	E
Çakmur	E
Çalapkulu	E
Çalapöver	E
Çalapverdi	E
Çalgan	E
Çalikbey	E
Çalikusu	K
Çalim	U
Çalin	E
Çalis	E
Çaliskan	U
Çalkan	E
Çalkara	E
Çalkin	E
Çalti	E
Çam	E
Çamak	E
Çambel	E
Çamer	E
Çamok	E
Çandar	E
Çandarli	E
Çanga	E
Çangal	E
Çankara	E
Çankaya	E
Çapan	E
Çapaner	E
Çapar	E
Çapin	E
Çapkan	E
Çarlan	E
Çarman	E
Çav	E
Çavas	E
Çavdar	E
Çavdur	E
Çavlan	E
Çavli	E
Çavuldur	E
Çavus	E
Çaydam	E
Çaydamar	E
Çayhan	E
Çaykara	E
Çaylak	E
Çaylan	U
Çaynak	E
Çelikbas	E
Çelikhan	E
Çelikkan	E
Çelikkanat	E
Çelikkaya	E
Çeliktan	E
Çeliktas	E
Çelikyay	E
Çesminaz	K
Çetinalp	E
Çetinay	E
Çetinkaya	E
Çetintas	E
Çevikcan	E
Çida	E
Çidal	E
Çidam	E
Çidamli	E
Çiga	E
Çigal	E
Çinak	E
Çinar	U
Çinay	E
Çiray	E
Çitak	E
Çitanak	E
Çilhan	K
Çilhanim	K
Çiltay	E
Çimnaz	K
Çintan	E
Çintay	E
Çiray	E
Çoban	E
Çobanyildizi	K
Çoga	E
Çogahan	E
Çogan	E
Çogas	E
Çogay	E
Çokan	E
Çokar	E
Çokay	E
Çokman	E
Çolak	E
Çolpan	U
Çopar	E
Çopuralp	E
Çora	E
Çorak	E
Çoturay	E
Çuga	E
Çulpan	E
Çuvas	E
Dadak	E
Dadas	E
Dag	E
Daga	E
Dagasan	E
Dagdelen	E
Daghan	E
Dagtekin	E
Dai	E
Daim	E
Daime	K
Dal	U
Dalan	E
Dalay	E
Dalayer	E
Dalbas	E
Dalboga	E
Dalda	E
Daldal	E
Daldiken	E
Dalgiç	E
Dalim	E
Dalkiliç	E
Dalkoç	E
Dalokay	E
Daltekin	E
Dalyan	E
Damar	E
Damla	K
Danis	U
Danisman	E
Danis	E
Danisment	E
Danyal	E
Dara	E
Darcan	E
Darga	E
Daver	E
Davran	E
Davut	E
Daya	K
Dayahatun	K
Dayanç	E
Dayar	E
Daye	K
Dayi	E
Daylak	E
Deha	U
Dehan	K
Delikan	E
Delikanli	E
Demirag	E
Demiralp	E
Demiray	E
Demirbag	E
Demirbas	E
Demirboga	E
Demircan	E
Demirçay	E
Demirhan	E
Demirkan	E
Demirkaya	E
Demirkiran	E
Demirman	E
Demirsah	E
Demirtas	E
Demirtav	E
Demirtay	E
Demokan	E
Denizalp	E
Denizcan	E
Denizhan	U
Denizman	E
Denktas	E
Derman	U
Dervisani	E
Dervishan	E
Derya	U
Deryadil	E
Deryanur	K
Devran	U
Diba	K
Diclehan	K
Didar	K
Dikalp	E
Dikay	E
Dikbas	E
Dikbay	E
Dikboga	E
Dikçam	E
Dikdal	E
Diktas	E
Dila	K
Dilâra	K
Dilay	K
Dilbaz	K
Dildade	K
Dildar	K
Dilercan	E
Dilferah	K
Dilfeza	K
Dilhan	K
Dilhayat	K
Dilmaç	E
Dilman	K
Dilrüba	K
Dilsafa	K
Dilsaz	K
Dilsitan	K
Dilsah	K
Dilsat	K
Dinçalp	E
Dinçay	U
Dinççag	E
Dinçkal	E
Dinçkaya	E
Dinçsan	E
Dinçsav	E
Dinçsay	E
Dinçtas	E
Dindar	E
Dirahsan	K
Dirayet	K
Diribas	E
Dirican	E
Dirsehan	E
Dizdar	E
Doga	U
Dogan	E
Doganalp	E
Doganay	U
Doganbas	E
Doganbey	E
Doganbike	K
Doganer	E
Dogangün	E
Doganhan	E
Dogannur	K
Dogansah	E
Dogantan	E
Dogantimur	E
Dogay	K
Dogudan	E
Doguhan	E
Dogukan	E
Dolan	E
Dolaner	E
Dolay	E
Dolunay	U
Domaniç	E
Donat	E
Dora	E
Dorak	E
Dorukhan	E
Dorukkan	E
Dölaslan	E
Dönmezcan	E
Duduhan	K
Duhan 	K
Duman	E
Dumanbey	E
Dura	E
Duracan	E
Durak	E
Dural	E
Duran	E
Duranay	E
Duraner	E
Duransoy	E
Durantekin	E
Duray	E
Durcan	K
Durhan	E
Durkadin	K
Durkaya	E
Durualp	E
Durubay	E
Durucan	E
Duruhan	E
Durukadin	K
Durukal	E
Durukan	E
Durusan	E
Duysal	K
Dündar	E
Dündaralp	E
Dürdane	K
Dürefsan	K
Dürrüsehvar	K
Düsvar	E
Ebrak	E
Ecebay	E
Ecehan	U
Ecekan	E
Eda	K
Edadil	K
Edagül	K
Edgüalp	E
Edgübay	E
Edgükan	E
Efdal	U
Efekan	E
Efgan	E
Efnan	E
Efrasiyap	E
Efza	K
Ejderhan	E
Elaldi	K
Elfaz	E
Elhan	E
Eliaçik	E
Elitas	E
Elmas	K
Elvan	U
Elveda	K
Emanet	U
Emanullah	E
Embiya	E
Emetullah	K
Emirhan	E
Emirsah	E
Emrah	E
Emran	E
Emrullah	E
Emsal	U
Enbiya	E
Enfal	E
Enginalp	E
Enginay	U
Engintalay	E
Enhar	E
Ensar	E
Ensari	E
Eracar	E
Erakalin	E
Erakinci	E
Eraksan	E
Eral	E
Eralkan	E
Eralp	E
Eraltay	E
Erandaç	E
Eranil	E
Eraslan	E
Eratli	E
Eray	U
Eraydin	E
Erbas	E
Erbasat	E
Erbatur	E
Erbay	U
Erboga	E
Ercan	E
Ercihan	E
Ercivan	E
Erdag	E
Erdal	E
Erdemalp	E
Erdemay	K
Erdenalp	E
Erdenay	U
Erdibay	E
Erdogan	E
Erduran	E
Erenalp	E
Erenay	U
Erencan	E
Erenkara	E
Ergalip	E
Ergazi	E
Erginal	E
Erginalp	E
Erginay	E
Erginbay	E
Ergincan	E
Ergunalp	E
Erguvan	K
Ergünay	E
Erhan	E
Erimsah	E
Erkal	E
Erkan	E
Erkarslan	E
Erkas	E
Erkaya	E
Erkinay	E
Erkiral	E
Erkman	E
Erkoçak	E
Erksal	E
Erksan	E
Erkutay	E
Erman	E
Erna	K
Ernoyan	E
Erogan	E
Erokay	E
Eronat	E
Erozan	E
Ersagun	E
Ersal	E
Ersalmis	E
Ersan	E
Ersav	E
Ersavas	E
Ersay	E
Ersayin	E
Ersunal	E
Ersahan	E
Ersan	E
Ersat	E
Ertaç	E
Ertan	E
Ertas	E
Ertay	E
Ertaylan	E
Ertepinar	E
Ertugay	E
Ertuna	E
Ertunca	E
Ertuncay	E
Ertunga	E
Erturan	E
Erünal	E
Eryalçin	E
Eryaman	E
Eryavuz	E
Eryilmaz	E
Erzade	E
Erzan	U
Esat	E
Esedullah	E
Esenbay	E
Esenboga	E
Esendag	E
Esendal	U
Esenkal	E
Esertas	E
Eskinalp	E
Esma	K
Esmahan	K
Esmeray	K
Esna	K
Esra	K
Esay	K
Esfak	E
Esraf	E
Evcan	U
Evhat	E
Evliya	E
Evran	E
Evrenata	E
Eyyam	E
Ezelhan	E
Fadil	E
Fadila	K
Fadik	K
Fadile	K
Fadim	K
Fadime	K
Fahim	E
Fahime	K
Fahir	E
Fahire	K
Fahrettin	E
Fahri	E
Fahriye	K
Fahrünnisa	K
Faik	E
Faika	K
Faiz	E
Faize	K
Fakih	E
Fakihe	K
Fakir	E
Fakirullah	E
Falih	E
Fani	E
Fariha	K
Farik	E
Faris	E
Farise	K
Faruk	E
Fasih	E
Fasihe	K
Fatih	E
Fatin	E
Fatine	K
Fatma	K
Fatmagül	K
Fatmanur	K
Fato	K
Fatos	K
Faysal	E
Fazil	E
Fazila	K
Fazilet	K
Fazli	E
Fazlullah	E
Feda	U
Fedai	E
Fedakâr	U
Fehamet	U
Fehamettin	E
Fehimdar	E
Fekahet	K
Feragat	E
Ferah	U
Ferahet	K
Ferahfeza	K
Ferahi	E
Ferahnisa	K
Ferahnur	K
Ferahnüma	K
Ferahru	K
Feramus	E
Feramuz	E
Feraset	K
Feray	U
Feraye	K
Fercan	E
Ferda	U
Ferdal	E
Ferdane	K
Ferdaniye	K
Ferdar	E
Ferhan	U
Ferhat	E
Ferhattin	E
Ferican	K
Feriha	K
Feritkan	E
Ferkan	E
Ferman	E
Fermani	E
Fersan	E
Feruzat	E
Ferzan	E
Ferzane	K
Fetanet	K
Fethullah	E
Fettah	E
Fevzullah	E
Feyha	U
Feyman	U
Feyyaz	E
Feyza	K
Feyzan	U
Feyzullah	E
Feza	U
Fezahan	E
Fezai	E
Fezanur	K
Firat	E
Fitnat	K
Fidan	K
Fidangül	K
Figan	K
Filbahar	K
Firaz	K
Firkat	K
Firuzan	K
Fitnat	K
Fuat	E
Fulya	K
Funda	K
Furkan	E
Füruzan	K
Gaffar	E
Gafir	E
Gafur	E
Galibe	K
Galip	E
Gamze	K
Gani	E
Ganime	K
Ganimet	K
Ganiye	K
Garibe	K
Garip	E
Gavsi	E
Gaye	K
Gayret	E
Gayur	E
Gazal	U
Gazale	K
Gazanfer	E
Gazel	U
Gazi	E
Gedikbas	E
Gedikbay	E
Gediktas	E
Gelenay	K
Gencal	E
Gencalp	E
Gencaslan	E
Gencay	U
Gençaga	E
Gençalp	E
Gençaslan	E
Gençay	U
Gençkal	E
Gençsav	E
Gençtan	E
Geray	E
German	E
Gezenay	E
Giyas	E
Giyasettin	E
Giyasi	E
Giray	E
Girayalp	E
Girayer	E
Girayhan	E
Girginalp	E
Girizan	K
Gizay	E
Gonca	K
Goncafem	K
Goncafer	K
Goncagül	K
Goncater	K
Gökalp	E
Gökay	U
Gökbaran	E
Gökbay	E
Gökbayrak	E
Gökbora	E
Gökbudak	E
Gökcan	E
Gökçebala	E
Gökçebalan	E
Gökdal	E
Gökdogan	E
Gökduman	K
Gökhan	E
Gökmenalp	E
Göksal	U
Göksaltuk	E
Göksan	E
Göksav	E
Göksay	E
Göksan	K
Göktalay	E
Göktan	E
Göktas	E
Göktay	E
Göktulga	E
Göktuna	E
Gökyay	E
Gönülay	K
Göral	E
Görgünay	E
Görgüncan	E
Gözal	K
Gözalan	K
Gözay	E
Gözaydin	E
Gücal	E
Gücalp	E
Güçal	E
Güçalp	E
Güçhan	E
Güçkan	E
Güçkanat	E
Güçlübay	E
Güçlühan	E
Güçlükhan	E
Güçsal	E
Güçsalan	E
Güçsan	E
Gülaç	K
Gülaçti	K
Gülal	K
Gülara	K
Gülasli	K
Gülasya	K
Gülay	K
Gülaydin	K
Gülayim	K
Gülayse	K
Gülbadem	K
Gülbag	K
Gülbahar	K
Gülbanu	K
Gülbay	E
Gülbeyaz	K
Gülcan	K
Gülcanan	K
Gülcemal	K
Gülcihan	K
Güldal	K
Güldali	K
Güldan	K
Güldane	K
Güldehan	K
Güldogan	U
Güldünya	K
Güleda	K
Gülefsan	K
Gülenay	K
Gülendam	K
Güleray	K
Gülercan	K
Gülerman	E
Gülertan	E
Gülfam	K
Gülfeda	K
Gülferah	K
Gülfesan	K
Gülfeza	K
Gülfidan	K
Gülgonca	K
Gülhan	U
Gülhanim	K
Gülhatir	K
Gülhatun	K
Gülhayat	K
Gülinaz	K
Gülistan	K
Gülizar	K
Gülkadin	K
Gülkan	E
Güllühan	K
Güllüsah	K
Güllüsan	K
Gülmisal	K
Gülnar	K
Gülnare	K
Gülnazik	K
Gülnihal	K
Gülsalin	K
Gülsan	K
Gülsanem	K
Gülsay	K
Gülsefa	K
Gülsema	K
Gülsima	K
Gülsuna	K
Gülsunam	K
Gülsunan	K
Gülsunar	K
Gülsad	K
Gülsadiye	K
Gülsah	K
Gülsahin	E
Gülsan	K
Gültaç	K
Gültan	U
Gültane	K
Gültas	E
Gültaze	K
Gülümay	K
Gülzar	K
Gülziba	K
Güman	E
Gümüshatun	K
Gümüstan	E
Gümüstay	E
Günaç	U
Günak	E
Günal	U
Günalan	E
Günalp	E
Günaltan	E
Günaltay	E
Günan	U
Günana	K
Günay	U
Günaydin	U
Günbatu	K
Günbay	E
Günçag	E
Gündal	U
Gündas	E
Gündogan	E
Gündogar	E
Gündüzalp	E
Gündüzhan	E
Günebakan	K
Güneral	E
Güneralp	E
Güneray	E
Günerkan	E
Günerman	E
Güneshan	E
Güneshanim	K
Günhan	U
Günkan	E
Günkaya	E
Günkutan	E
Günnar	K
Günnaz	K
Günsar	E
Günsav	E
Günsah	K
Günsiray	U
Güntan	U
Günvar	E
Günyaruk	E
Gürak	E
Gürakan	E
Gürakin	E
Güral	E
Güran	E
Gürarda	E
Gürata	E
Güray	U
Gürbas	E
Gürbaskan	E
Gürbay	E
Gürboga	E
Gürcan	E
Gürdal	E
Gürhan	E
Gürkan	E
Güvenay	K
Güzay	K
Güzelay	K
Güzelcan	K
Güzinay	K
Hacer	K
Hacergül	K
Hacigül	K
Hacihanim	K
Hacikadin	K
Hadiye	K
Hadra	K
Hafiza	K
Hafide	K
Hafize	K
Hakan	E
Hakikat	U
Hakki	E
Haktan	U
Hakverdi	E
Halâs	E
Halâskâr	E
Halâvet	K
Haldun	E
Hale	K
Halef	E
Halenur	K
Halide	K
Halife	E
Halil	E
Halile	K
Halilullah	E
Halim	E
Halime	K
Halis	E
Halise	K
Halit	E
Halittin	E
Halûk	E
Hamaset	E
Hamdi	E
Hamdiye	K
Hamdullah	E
Hami	E
Hamide	K
Hamil	E
Hamis	E
Hamise	K
Hamit	E
Hamiye	K
Hamiyet	K
Hamra	K
Hamza	E
Han	E
Hanalp	E
Hanbegüm	K
Hanbegendi	K
Hanbek	E
Hanbey	E
Hanbike	K
Hanbiken	K
Handan	K
Hande	K
Hanedan	E
Hanefi	E
Hanim	K
Hanimkiz	K
Hanif	E
Hanife	K
Hankan	E
Hankiz	K
Hansoy	E
Hansultan	K
Hanüman	K
Hanzade	U
Harbiye	K
Hare	K
Harika	K
Harun	E
Hasan	E
Hasanalp	E
Hasane	E
Hasay	K
Hasbek	E
Hasbi	E
Hasefe	E
Hasene	K
Hasgül	K
Hasibe	K
Hasip	E
Haskiz	K
Haslet	E
Hasna	K
Haspolat	E
Hasret	U
Hasim	E
Hasmet	E
Hasmettin	E
Hatem	E
Hatemî	E
Hatira	K
Hatice	K
Haticenur	K
Hatif	E
Hatife	K
Hatim	E
Hatime	K
Hatip	E
Hattat	E
Hatun	K
Hatunana	K
Hava	K
Haver	K
Havi	E
Havva	K
Hayal	K
Hayalî	E
Hayat	K
Hayati	E
Haydar	E
Hayir	E
Hayirgül	K
Hayran	U
Hayrani	E
Hayret	U
Hayrettin	E
Hayri	E
Hayriye	K
Hayrullah	E
Hayrünnisa	K
Hazal	K
Hazan	K
Hazar	E
Hazel	K
Hazik	E
Hazim	E
Hazime	K
Hazin	K
Hazine	K
Hazret	E
Hemta	K
Heyecan	U
Hezarfen	E
Hifzirrahman	E
Hifzullah	E
Hincal	E
Hiraman	K
Hizlan	E
Hicap	E
Hicran	K
Hiçyilmaz	E
Hidayet	U
Hidayettin	E
Hikmetullah	E
Hilkat	U
Hisar	E
Hitam	E
Hoseda	K
Hosfidan	K
Hoskadem	K
Huban	K
Hudavendigâr	E
Hudavent	E
Hudaverdi	E
Hudayi	E
Hulagu	E
Hulya	K
Hunalp	E
Hurican	K
Hüdavendigâr	E
Hüdavent	E
Hüdaver	U
Hüdaverdi	E
Hüdayi	E
Hükminaz	K
Hükümdar	E
Hülya	K
Hüma	K
Hümayun	E
Hümeyra	K
Hüray	U
Hürcan	U
Hürdogan	E
Hürkal	E
Hürkan	U
Hürnaz	K
Hüryasar	E
Hüsam	E
Hüsamettin	E
Hüsna	K
Hüveyda	K
Hüzzam	K
Ilgar	E
Ilgarli	E
Ilgaz	U
Ilgazcan	E
Ilgazer	E
Ilicak	E
Ilican	U
Ira	E
Iraz	K
Irmak	U
Isikal	E
Isikalp	E
Isikay	E
Isikhan	E
Isikkan	E
Isiktas	E
Isilak	E
Isilar	U
Isilay	K
Isildar	K
Isiltan	U
Isiman	E
Isinay	K
Isinbay	E
Isinhan	E
Isinkan	E
Isinsal	K
Isitan	U
Iba	K
Ibad	E
Ibadet	E
Ibadullah	E
Ibat	E
Ibrahim	E
Içaçan	E
Ifakat	K
Ihsan	U
Ihvan	E
Ihya	U
Ikbal	U
Ikram	U
Ikrami	E
Ilal	E
Ilalan	E
Ilaldi	E
Ilalmis	E
Ilarslan	E
Ilay	K
Ilayda	K
Ilaydin	E
Ilbars	E
Ilbasan	E
Ilbasmis	E
Ilbasti	E
Ilbas	E
Ilbay	E
Ilboga	E
Ilbozan	E
Ilcan	E
Ilgar	E
Ilgazi	E
Ilginay	K
Ilham	E
Ilhami	E
Ilhan	E
Ilimdar	E
Ilkan	E
Ilkay	U
Ilkbahar	K
Ilkbal	K
Ilkcan	K
Ilkehan	E
Ilknaz	K
Ilkutay	E
Ilkünsal	E
Ilkyaz	K
Ilpars	E
Ilsavas	E
Ilsavun	E
Iltan	E
Iltas	E
Iltay	E
Ilvan	E
Ilyas	E
Imadettin	E
Imam	E
Imamettin	E
Iman	E
Imat	E
Imbat	K
Imdat	E
Inak	E
Inal	U
Inalbey	E
Inalcik	E
Inalkut	E
Inaltekin	E
Inan	U
Inanç	U
Inançli	E
Inanir	E
Inanöz	E
Inayet	U
Incebay	E
Insaf	K
Ipar	K
Irfan	U
Irfani	E
Irfaniye	K
Irfat	E
Irsat	E
Isa	E
Isfendiyar	E
Ishak	E
Ismail	E
Ismican	K
Ismihan	K
Isminaz	K
Israfil	E
Istemihan	E
Istikbal	U
Isvan	E
Iscan	E
Isman	E
Itibar	K
Iyidogan	E
Iyisan	E
Izboga	E
Izbudak	E
Jale	K
Kaan	E
Kadagan	E
Kadam	U
Kadem	U
Kader	U
Kadin	K
Kadinana	K
Kadincik	K
Kadife	K
Kadim	E
Kadime	K
Kadir	E
Kadire	K
Kadrettin	E
Kadri	E
Kadrihan	E
Kadriye	K
Kafar	E
Kagan	E
Kahir	E
Kahraman	E
Kaim	E
Kakinç	E
Kala	E
Kalagay	E
Kalender	E
Kalgay	E
Kalkan	E
Kalmik	E
Kalmuk	E
Kam	E
Kamaci	E
Kaman	E
Kamanbay	E
Kamar	E
Kambay	E
Kamber	E
Kamer	K
Kamet	E
Kâmran	U
Kamu	E
Kâmuran	U
Kanagan	E
Kanak	E
Kanat	E
Kanbay	E
Kanber	E
Kandemir	E
Kaner	E
Kanik	E
Kanikor	E
Kanit	E
Kani	E
Kaniye	K
Kanpolat	E
Kanpulat	E
Kansu	E
Kansun	E
Kanturali	E
Kantürk	E
Kanun	E
Kanver	E
Kapagan	E
Kapar	E
Kapçak	E
Kapkin	E
Kaplan	E
Kaptan	E
Kara	E
Karaalp	E
Karaca	U
Karacakurt	E
Karacan	E
Karaci	E
Karaçar	E
Karaçay	E
Karaçelik	E
Karadag	E
Karademir	E
Karadeniz	E
Karadogan	E
Karaduman	E
Karadut	K
Karaer	E
Karagöz	U
Karahan	E
Karakalpak	E
Karakan	E
Karakas	E
Karakaya	E
Karakiz	K
Karakoca	E
Karakoç	E
Karakoyun	E
Karakucak	E
Karakurt	E
Karakus	E
Karaman	E
Karamik	E
Karamuk	E
Karamut	E
Karamürsel	E
Karan	E
Karanalp	E
Karanbay	E
Karanfil	K
Karaoglan	E
Karaörs	E
Karapars	E
Karasal	E
Karasu	E
Karasungur	E
Karasüyek	E
Karasin	E
Karatan	E
Karatas	E
Karatay	E
Karatekin	E
Karatün	E
Karayagiz	E
Karayel	E
Karcan	E
Kardan	K
Kardelen	K
Kardes	E
Kargi	E
Kargin	E
Karginalp	E
Karhan	E
Karik	E
Karindas	E
Karlik	E
Karlu	E
Karluk	E
Karlukhan	E
Karsel	K
Kartal	E
Kartay	E
Kartekin	E
Karyagdi	K
Kasal	E
Kasar	E
Kasim	E
Kasirga	E
Kaska	E
Kati	E
Katihan	E
Katun	K
Kavas	E
Kavçin	E
Kavruk	E
Kavurt	E
Kavurtbey	E
Kavurthan	E
Kavvas	E
Kay	E
Kaya	E
Kayaalp	E
Kayacan	E
Kayaer	E
Kayagün	E
Kayagündüz	E
Kayahan	E
Kayan	U
Kayansel	U
Kayar	E
Kayas	E
Kayatekin	E
Kayatimur	E
Kayatürk	E
Kaygisiz	E
Kaygusuz	E
Kayhan	E
Kayi	E
Kayibay	E
Kayihan	E
Kayin	E
Kayit	E
Kayitmis	E
Kaymak	K
Kaymas	E
Kaymaz	E
Kaynak	E
Kaynar	E
Kaynarkan	E
Kayra	U
Kayraalp	E
Kayrahan	E
Kayral	E
Kayran	E
Kayser	E
Kayyum	E
Kazak	E
Kazakhan	E
Kazan	E
Kazanhan	E
Kazgan	E
Kelesbay	E
Keleshan	E
Kemal	E
Kemalettin	E
Kemandar	E
Kenan	E
Keramet	U
Keramettin	E
Kerami	E
Keremsah	E
Keriman	K
Kerimhan	E
Kerman	E
Kervan	E
Keskinay	E
Keyhan	E
Kezban	K
Keziban	K
Kilavuz	E
Kiliçal	E
Kiliçalp	E
Kiliçaslan	E
Kiliçbay	E
Kiliçhan	E
Kinalp	E
Kinay	E
Kinayman	E
Kinaytürk	E
Kinikaslan	E
Kipçak	E
Kiraç	E
Kiralp	E
Kiran	E
Kiranalp	E
Kiraner	E
Kirat	E
Kiratli	E
Kiray	E
Kirbay	E
Kirboga	E
Kirca	E
Kirdar	E
Kirdarli	E
Kirhan	E
Kirman	E
Kirtay	E
Kivanç	U
Kivançer	E
Kivançli	E
Kiyam	E
Kiyan	E
Kiyas	E
Kizan	E
Kizhanim	K
Kizilaslan	E
Kizilates	E
Kizilbars	E
Kizilboga	E
Kizilelma	E
Kizilpars	E
Kizilyalim	E
Kizimay	K
Kizkina	K
Kibar	U
Kibare	K
Kibariye	K
Kiçialp	E
Kiçihan	E
Kifaye	K
Kifayet	K
Kimya	K
Kinas	E
Kinyas	E
Kipcan	E
Kiram	E
Kiramettin	E
Kirami	E
Kiraz	K
Kirman	E
Kirmansah	E
Kisihan	E
Koca	E
Kocaalp	E
Kocademir	E
Kocagöz	E
Kocaman	E
Kocatas	E
Kocatay	E
Kocatürk	E
Kocaün	E
Koçak	E
Koçakalp	E
Koçakaslan	E
Koçaker	E
Koças	E
Koçay	E
Koçboga	E
Koçhan	E
Koçkan	E
Koçkar	E
Kolat	E
Kolçak	E
Koldan	E
Koldas	E
Koman	E
Komutan	E
Konak	E
Konan	E
Konca	K
Koncagül	K
Kongar	E
Kongarata	E
Konguralp	E
Kongurtay	E
Konrat	E
Konuralp	E
Konurata	E
Konuray	E
Kopan	E
Koparal	E
Kora	E
Koral	E
Koralp	E
Koraltan	E
Koramaz	E
Koraslan	E
Koray	E
Korcan	E
Korçak	E
Korçan	E
Korday	E
Korgan	E
Korhan	E
Korkan	E
Korkmaz	E
Korkutalp	E
Korkutata	E
Korman	E
Kortak	E
Kortan	E
Kortas	E
Kortay	E
Korugan	E
Koryak	E
Koryay	E
Kosal	E
Kosukhan	E
Kotuzhan	E
Koyak	E
Koyas	U
Koytak	E
Koytan	E
Kozak	E
Köksal	U
Köksan	E
Köktan	E
Köktas	E
Köktay	E
Közcan	E
Kubat	E
Kubilay	E
Kuday	E
Kudayberdi	E
Kudretullah	E
Kulan	K
Kumral	K
Kutal	K
Kutan	K
Kutay	U
Kutlay	K
Kutluay	K
Kutsal	K
Kutsalan	K
Kutsalar	K
Kutsan	K
Kuyas	E
Kuzay	K
Kübra	K
Kürsad	E
Kürsat	E
Lala	E
Lâlehan	K
Lâlezar	K
Lâmia	K
Lâmiha	K
Lema	K
Leman	K
Lerzan	K
Letafet	K
Leyan	K
Liyakat	K
Liyan	K
Maarif	E
Macide	K
Macit	E
Madelet	K
Magfiret	K
Magrip	E
Magrur	E
Mahbube	K
Mahbup	E
Mahçiçek	K
Mahfer	K
Mahfi	E
Mahfuz	E
Mahinev	K
Mahi	E
Mahinur	K
Mahir	E
Mahire	K
Mahizar	K
Mahizer	K
Mahmude	K
Mahmur	E
Mahmure	K
Mahmut	E
Mahnur	K
Mahpare	K
Mahperi	K
Mahpeyker	K
Mahra	E
Mahru	K
Mahrur	K
Mahser	E
Mahsun	E
Mahsure	K
Mahsut	E
Mahten	K
Mahter	K
Mahya	E
Maide	K
Mail	E
Makal	E
Makbul	E
Makbule	K
Maklûbe	K
Maksude	K
Maksum	E
Maksume	K
Maksur	E
Maksure	K
Maksut	E
Makul	E
Malik	E
Malike	K
Malkoç	E
Malkoçoglu	E
Mançer	E
Manço	E
Mançu	E
Mançuhan	E
Manga	E
Mangalay	E
Manolya	K
Mansur	E
Mansure	K
Manzur	E
Maral	U
Marifet	K
Marti	K
Maruf	E
Marufe	K
Marziye	K
Masum	E
Masume	K
Masallah	E
Masuk	E
Masuka	K
Matlup	E
Matuk	E
Mavi	K
Mavisel	K
Mavis	K
Maya	K
Mazhar	E
Mazlum	E
Mazlume	K
Medar	K
Medayin	E
Mediha	K
Mefhar	E
Mefharet	K
Mehlika	K
Mehpare	K
Mehtap	K
Melâhat	K
Melda	K
Meleknaz	K
Meleksah	K
Meliha	K
Melikhan	E
Meliksah	E
Melisa	K
Melissa	K
Memduha	K
Menaf	E
Mengüalp	E
Mengübay	E
Mengütas	E
Mengütay	E
Mennan	E
Meral	U
Meram	K
Mercan	K
Merdan	E
Mertkal	E
Mertkan	E
Merzuka	K
Mesadet	K
Mestan	E
Mestinaz	K
Mesahir	E
Mesale	K
Metehan	E
Metinkaya	E
Meva	K
Mevlâna	E
Meyransa	K
Meyyal	K
Misra	K
Midhat	E
Mihman	K
Mihriban	K
Mihrican	U
Mihrimah	K
Mihrinaz	K
Mihrinisa	K
Mihrisah	K
Mimoza	K
Mina	K
Miraç	E
Miran	E
Miranmir	E
Mirat	E
Miray	K
Mircan	U
Mirhan	U
Mirza	E
Mirzat	E
Misal	K
Mithat	E
Miyase	K
Mocan	E
Moran	E
Moray	U
Muadelet	K
Muaffak	E
Muallâ	K
Muallim	E
Muammer	U
Muarra	K
Muattar	K
Muazzam	E
Muazzez	K
Mubahat	K
Mugdat	E
Muhacir	E
Muhaddere	K
Muhammed	E
Muhammet	E
Muhar	E
Muharrem	E
Muhtar	E
Mukaddem	E
Mukadder	U
Mukaddes	K
Munar	E
Mungan	E
Murat	E
Murathan	E
Murtaza	E
Musa	E
Musaddik	E
Musafat	E
Musaffa	K
Mustafa	E
Mutahhar	U
Mutarra	K
Mutasim	E
Mutena	K
Mutia	K
Mutlualp	E
Mutluay	U
Mutlubay	E
Mutluhan	E
Mutlukan	E
Mutlukhan	E
Muvaffak	E
Muvahhide	K
Muvahhit	E
Muvakkar	U
Muzaffer	U
Mübahat	K
Mübarek	E
Mübareke	K
Müberra	K
Mücahit	E
Mücahittin	E
Mücap	E
Müçteba	E
Müheyya	K
Mühürdar	E
Müjdat	E
Mükâfat	K
Müminhan	E
Mümtaz	E
Mümtaze	K
Münasip	E
Münteha	K
Müsemma	K
Müstakim	E
Müstakime	K
Müstecap	E
Müstesna	K
Müsahit	E
Müsfika	K
Müstak	E
Müsteba	E
Müzahir	E
Müzdat	E
Naci	E
Nacil	E
Naciye	K
Nadi	E
Nadide	K
Nadim	E
Nadime	K
Nadir	E
Nadire	K
Nadiye	K
Nafi	E
Nafia	K
Nafile	K
Nafiye	K
Nafiz	E
Nafize	K
Nagehan	K
Nagme	K
Nahide	K
Nahire	K
Nahit	E
Naibe	K
Nail	E
Naile	K
Naim	E
Naime	K
Naip	E
Naire	K
Nakip	E
Naki	E
Nakip	E
Nakiye	K
Naksidil	K
Nalân	K
Namal	E
Namdar	E
isimler	K
Namik	E
Namika	K
Nami	E
Namiye	K
Nardan	K
Nardane	K
Nargül	K
Narhanim	K
Narin	K
Nariye	K
Narkadin	K
Nart	E
Narter	E
Nas	E
Nasfet	K
Nasif	E
Nasir	E
Nasira	K
Nasibe	K
Nasih	E
Nasiha	K
Nasip	U
Nasir	E
Nasiye	K
Nasrettin	E
Nasri	E
Nasrullah	E
Nasuh	E
Nasuhi	E
Naside	K
Nasir	E
Nasire	K
Nasit	E
Natik	E
Natika	K
Natuk	E
Natuvan	E
Nayman	E
Naz	K
Nazan	K
Nazar	E
Nazbike	K
Nazende	K
Nazenin	K
Nazhanim	K
Nazidil	K
Nazim	E
Nazima	K
Nazir	E
Nazif	E
Nazife	K
Nazik	U
Nazir	E
Nazire	K
Nazlan	K
Nazli	K
Nazlican	K
Nazligül	K
Nazlihan	K
Nazlim	K
Nazmi	E
Nazmiye	K
Nebahat	K
Nebahattin	E
Necat	U
Necati	E
Neccar	E
Nefaset	K
Nehar	E
Nejat	E
Neriman	K
Neslihan	K
Neslisah	K
Nesat	U
Nesecan	K
Neva	K
Neval	K
Nevale	K
Nevbahar	K
Nevcan	K
Nevcivan	U
Neveda	K
Nevnihal	K
Nevra	K
Nevsal	E
Nevsale	K
Nevvare	K
Nevzat	U
Neyran	K
Nezafet	K
Nezahat	K
Nezahattin	E
Nezahet	K
Nezaket	K
Nida	U
Nidai	E
Nihade	K
Nihai	E
Nihal	K
Nihan	K
Nihat	E
Nihayet	U
Nilay	K
Nilhan	U
Nimetullah	E
Niran	K
Nisa	K
Nisan	U
Nisani	E
Nisvan	K
Nisan	E
Nisanbay	E
Niyaz	U
Niyazi	E
Nizam	E
Nizamettin	E
Nizami	E
Nizar	E
Nogay	E
Noyan	E
Nuhcan	E
Nuhkan	E
Numan	E
Nural	U
Nuralp	E
Nuran	K
Nurani	E
Nuratay	E
Nuray	U
Nuraydin	E
Nurbaki	E
Nurbanu	K
Nurbay	E
Nurcan	U
Nurcihan	U
Nurdag	U
Nurdal	U
Nurdan	U
Nurdanay	K
Nurdane	K
Nurdogan	U
Nurefsan	K
Nurfeza	K
Nurfidan	K
Nurhan	U
Nurhanim	K
Nurhayal	K
Nurhayat	K
Nurihak	E
Nurinisa	K
Nurkadin	K
Nurkan	U
Nurlan	K
Nurmah	K
Nursaç	K
Nursal	U
Nursan	U
Nursema	K
Nursima	K
Nursah	E
Nurtaç	U
Nurtan	K
Nurtane	K
Nurullah	E
Nurzat	E
Nuyan	E
Oba	E
Ocak	E
Ocan	E
Odhan	E
Odkan	E
Odkanli	E
Odman	E
Odyak	E
Odyakar	E
Odyakmaz	E
Oflas	E
Oflaz	U
Oflazer	E
Ogan	E
Oganalp	E
Oganer	E
Ogansoy	E
Ogeday	E
Ogan	E
Oganalp	E
Oganer	E
Ogansoy	E
Oganverdi	E
Ogulbali	E
Ogulbas	E
Ogulbay	E
Ogulcan	E
Ogulçak	E
Ogultan	E
Oguralp	E
Ogurata	E
Oguzalp	E
Oguzata	E
Oguzbala	E
Oguzbay	E
Oguzcan	E
Oguzhan	E
Oguzkan	E
Oguzman	E
Oguztan	E
Okakin	E
Okal	E
Okan	E
Okanalp	E
Okanay	E
Okandan	E
Okaner	E
Okar	E
Okat	E
Okatan	E
Okatar	E
Okatay	E
Okay	E
Okayer	E
Okbas	E
Okbay	E
Okboga	E
Okcan	E
Okdag	E
Okhan	E
Okkan	E
Okman	E
Oksal	E
Oksaldi	E
Oksalmis	E
Oksar	E
Oksay	E
Oksak	E
Oksan	U
Oksar	E
Oktan	E
Oktar	E
Oktas	E
Oktay	E
Okutan	E
Okuyan	E
Okyalaz	E
Okyan	E
Okyanus	U
Okyar	E
Okyay	E
Olca	U
Olcan	E
Olcay	U
Olcayhan	E
Olcayto	E
Olcaytu	E
Olcaytug	E
Olcaytürk	E
Oldaç	E
Oldag	E
Olgaç	E
Olgunay	E
Olkivanç	E
Olpak	E
Olsan	E
Omaca	E
Omaç	E
Omay	E
Omurca	E
Omurtak	E
Onan	E
Onar	E
Onaran	E
Onart	E
Onat	U
Onatkan	E
Onatkut	E
Onatsü	E
Onay	U
Onbulak	E
Ongan	E
Ongay	E
Ongunalp	E
Onuktan	E
Onultan	E
Onurad	E
Onural	E
Onuralp	E
Onurhan	E
Onurkan	E
Onursal	E
Onursan	E
Onursay	E
Opak	E
Orak	E
Orakay	E
Oral	E
Oralmis	E
Oran	E
Oranli	E
Oray	E
Orbay	E
Orcan	E
Orcaner	E
Orgunalp	E
Orguntay	E
Orgünalp	E
Orhan	E
Orkan	E
Orkutay	E
Orman	U
Ortaç	E
Ortak	E
Ortan	E
Ortanca	K
Oskan	E
Oskay	U
Osman	E
Otaci	E
Otag	E
Otak	E
Otakçi	E
Otamis	E
Otaran	E
Otay	E
Oya	K
Oyaçiçek	K
Oyal	E
Oyali	K
Oyalp	E
Oybozan	E
Oyhan	E
Oykan	E
Oymak	E
Oyman	E
Ozan	E
Ozanalp	E
Ozanay	E
Ozaner	E
Ozansoy	E
Ozansü	E
Ozgan	E
Öcal	E
Öçal	E
Ögeday	E
Ögütal	E
Ömüral	E
Ömürcan	U
Önad	E
Önal	U
Önalan	E
Önay	U
Önaydin	E
Öncübay	E
Öngay	E
Önkal	E
Önsal	E
Önsav	E
Öntas	E
Örsan	E
Örsay	E
Örskan	E
Örtan	E
Örtas	E
Örtay	E
Övünal	E
Özak	U
Özakan	E
Özakar	E
Özakay	E
Özakin	E
Özakinci	E
Özaktug	E
Özal	U
Özalp	E
Özalpman	E
Özalpsan	E
Özaltan	U
Özaltay	E
Özaltin	U
Özaltug	E
Özan	U
Özant	K
Özarda	E
Özari	E
Özark	E
Özarkin	E
Özaslan	E
Özata	E
Özatay	E
Özay	U
Özaydin	U
Özayhan	E
Özaytan	K
Özbag	E
Özbal	U
Özbala	E
Özbas	E
Özbasak	K
Özbatu	E
Özbay	E
Özbaydar	E
Özbekkan	E
Özboga	E
Özcan	U
Özcanan	K
Özçam	E
Özçinar	E
Özdag	E
Özdal	U
Özdamar	E
Özdilmaç	E
Özdoga	E
Özdogal	E
Özdogan	E
Özduran	E
Özekan	E
Özenay	K
Özercan	E
Özerdal	E
Özerhan	E
Özerman	E
Özertan	E
Özgebay	E
Özgenalp	E
Özgenay	E
Özgiray	E
Özgülay	K
Özgünay	E
Özgürcan	E
Özhakan	E
Özhan	E
Özilhan	E
Özinal	E
Özinan	U
Özkal	E
Özkan	E
Özkar	E
Özkaya	E
Özkayra	E
Özkerman	E
Özkinal	E
Özkinay	E
Özkula	E
Özkutal	E
Özkutay	E
Özkutsal	E
Özman	E
Özoktay	E
Özozan	E
Özpala	E
Özpinar	U
Özpolat	E
Özpulat	E
Özsan	U
Özsanli	E
Özsahin	E
Özsan	E
Öztan	E
Öztanir	E
Öztarhan	E
Öztas	E
Öztay	E
Öztaylan	E
Öztoygar	E
Öztuna	U
Özüak	E
Özyay	E
Özyuva	E
Padisah	E
Pak	U
Pakalin	E
Pakân	E
Pakbaz	E
Pakel	E
Paker	E
Paki	E
Pakize	K
Pakkan	E
Pakman	E
Paksan	E
Paksu	K
Paksüt	K
Pamir	U
Pamuk	K
Papatya	K
Parla	K
Parlak	K
Parlanur	K
Parlar	K
Payan	K
Paye	K
Payende	K
Payidar	K
Pekak	K
Pekay	K
Pekbal	K
Pekkan	K
Perican	K
Perihan	K
Perinisan	K
Perizat	K
Perran	K
Pervane	K
Peyman	K
Pinar	K
Pirlanta	K
Pitirca	K
Pitrak	K
Piran	K
Piraye	K
Polat	E
Poyraz	E
Punar	K
Pürsan	K
Raci	E
Racih	E
Raciye	K
Radi	E
Radife	K
Radiye 	K
Rafet	E
Rafettin	E
Rafi	E
Rafia	K
Rafih	E
Ragip	E
Ragibe	K
Ragbet	K
Rahi	E
Rahile	K
Rahim	E
Rahime	K
Rahiye	K
Rahman	E
Rahmani	E
Rahmet	U
Rahmeti	E
Rahmetullah	E
Rahmi	E
Rahmiye	K
Rahsan	U
Rahsende	K
Raif	E
Raife	K
Raik	E
Raika	K
Rakim	E
Rakime	K
Rakibe	K
Rakide	K
Rakime	K
Rakip	E
Ramazan	E
Rami	E
Ramis	E
Ramiye	K
Ramiz	E
Rana	K
Rasih	E
Rasiha	K
Rasim	E
Rasime	K
Rasin	E
Rasiye	K
Raside	K
Rasit	E
Ratibe	K
Ratip	E
Rauf	E
Raufe	K
Ravza	K
Rayet	E
Rayihan	E
Rayiha	K
Razi	E
Razi	E
Raziye	K
Rebia	K
Reca	E
Recai	E
Refah	K
Refahet	K
Refhan	U
Refia	K
Refika	K
Reftar	K
Regaip	E
Reha	U
Rehayeddin	E
Renan 	U
Renginar	K
Resai	E
Resane	K
Resulhan	E
Resat	E
Revan	U
Revza	K
Reyhan	K
Reyya	K
Reyyan	U
Rezan	K
Rezzak	E
Rezzan	K
Ridvan	E
Rifat	E
Riza	E
Rizkullah	E
Rizvan	E
Rical	E
Rifat	E
Rikap	E
Rikkat	K
Rindan	K
Risalet	U
Risalettin	E
Ruat	E
Ruhan	K
Ruhani	E
Ruhcan	E
Ruhfeza	K
Ruhsal	K
Ruhsar	K
Ruhsare	K
Ruhsat	U
Ruhsan	E
Ruhullah	E
Rüçhan	U
Rüksan	K
Rümeysa	K
Rüveyda	K
Rüveyha	K
Rüya	K
Saadet	K
Saadettin	E
Sacide	K
Sacit	E
Saçi	K
Sada	U
Sadak	E
Sadakat	E
Sadberk	K
Sadedil	K
Sadegül	K
Sadettin	E
Sadhezar	K
Sadik	E
Sadika 	K
Sadi	E
Sadice	K
Sadir	E
Sadiye	K
Sadrettin	E
Sadri	E
Sadriye	K
Sadullah	E
Sadun	E
Safa	U
Safder	E
Safer	E
Saffet	U
Safigül	K
Safi	E
Safinaz	K
Safinur	K
Safir	K
Safire	K
Safiye	K
Safiyet	K
Safiyüddin	E
Safter	E
Sagan	E
Saganak	E
Saganalp	E
Sagbilge	E
Sagbudun	E
Sagcan	E
Sagdiç	E
Sagin	E
Saginç	E
Sagit	E
Saglam	E
Saglamer	E
Saglar	E
Saglik	E
Sagman	E
Sagun	E
Sahavet	K
Sahba	K
Sahibe	K
Sahil	U
Sahip	E
Sahir	E
Sahire	K
Sahra	K
Sahure	K
Saibe	K
Saide	K
Saika	K
Saim	E
Saime	K
Saip	E
Sair	E
Saire	K
Sait	E
Sak	E
Saka	E
Sakin	E
Sakip	E
Saki	E
Sakibe	K
Sakin	E
Sakine	K
Sakman	E
Sal	E
Sala	E
Salâh	E
Salâhattin	E
Salâhi	E
Salan	E
Salâr	E
Salcan	E
Saldam	E
Salgur	E
Salik	E
Salikbey	E
Salikbike	K
Salinbike	K
Salih	E
Saliha	K
Salim	E
Salime	K
Salis	E
Salise	K
Salkim	K
Salkin	E
Salman	E
Saltan	U
Saltanat	K
Salti	E
Saltik	E
Saltuk	E
Saltukalp	E
Salur	E
Salurbay	E
Samahat	K
Samanur	K
Samet	E
Sami	E
Samih	E
Samiha	K
Samim	E
Samime	K
Samimi	E
Samin	E
Samir	E
Samire	K
Samiye	K
Samur	U
Samuray	E
Samurtay	E
San	E
Sanaç	E
Sanak	E
Sanal	U
Sanalp	E
Sanat	E
Sanavber	K
Sanay	U
Sanbay	E
Sanberk	E
Sancak	E
Sancaktar	E
Sancar	E
Sancarhan	E
Sançar	E
Sanduç	E
Sanem	K
Sanemnur	K
Saner	E
Sanevber	K
Sani	E
Sania	K
Sanih	E
Saniha	K
Saniye	K
Sanli	E
Sannur	K
Sansin	E
Sanver	E
Sar	E
Sara	K
Saraç	E
Saral	E
Saran	E
Sarbek	E
Sare	K
Sargan	E
Sargin	U
Sarginal	E
Sargut	E
Sarialp	E
Saribay	E
Sarica	E
Sariçam	E
Sariçiçek	K
Sarier	E
Sarigül	K
Sarigüzel	K
Sarihan	E
Sarikaya	E
Sarikiz	K
Saritas	E
Sarim	E
Sarkan	E
Sarmasik	K
Sarp	E
Sarper	E
Sarphan	E
Sarpkan	E
Sarpkin	E
Sarpkoç	E
Sart	E
Sartik	E
Saru	E
Saruca	E
Saruhan	E
Sarvan	E
Sati	U
Satia	K
Satibey	E
Satigül	K
Satihanim	K
Satilmis	E
Satu	K
Satuk	E
Satukbugra	E
Satvet	E
Sav	E
Sava	E
Savaci	E
Savak	E
Savas	E
Savasan	E
Savaser	E
Savaskan	E
Savat	E
Saver	E
Savgat	E
Savlet	E
Savni	E
Savniye	K
Savran	E
Savtekin	E
Savtunç	E
Savtur	E
Savun	E
Say	E
Saya	E
Sayan	E
Sayar	K
Saybay	E
Saydam	U
Saygi	U
Saygili	E
Saygin	U
Saygun	U
Saygül	K
Sayhan	E
Sayil	U
Sayilbay	E
Sayilgan	E
Sayim	E
Sayin	U
Sayinberk	E
Sayinbey	E
Sayiner	E
Saykal	E
Saykut	E
Saylam	E
Saylan	E
Saylav	E
Saylu	E
Sayman	E
Saymaner	E
Saynur	K
Sayraç	E
Sayrak	E
Sayran	K
Sayri	E
Sayru	E
Sayvan	E
Sayyat	E
Sazak	E
Seba	K
Sebahat	K
Sebahattin	E
Sebat	U
Sebati	E
Sebükalp	E
Secahat	E
Seçilay	K
Seda	U
Sedanur	K
Sedat	E
Sefa	U
Seha	U
Sehavet	K
Sehernaz	K
Sehhar	E
Sehhare	K
Sehran	E
Selâhattin	E
Selâmullah	E
Selay	K
Selcan	K
Selçukkan	E
Selda	K
Seldag	K
Selekman	E
Selhan	U
Selkan	E
Selma	K
Selman	E
Selva	K
Selvican	K
Selvihan	U
Selvinaz	K
Sema	K
Semagül	K
Semahat	U
Semai	E
Semanur	K
Semavi	E
Semiha	K
Semiramis	K
Semiray	E
Semra	K
Sena	U
Senai	E
Senal	K
Senar	K
Senay	K
Sencan	E
Seniha	K
Sera	K
Serad	E
Seralp	E
Seran	K
Serap	K
Seray	K
Serazat	E
Serbay	E
Sercan	U
Sercihan	E
Serdal	E
Serdar	E
Serdarhan	E
Serfiraz	K
Serhan	E
Serhas	E
Serhat	E
Serkan	E
Serma	K
Sernaz	K
Sernevaz	K
Serra	K
Sertaç	U
Sertap	U
Servinaz	K
Settar	E
Seval	K
Sevan	U
Sevay	U
Sevcan	U
Sevda	K
Sevdakâr	K
Sevenay	K
Sevencan	K
Severcan	K
Sevgican	K
Sevgihan	K
Sevginaz	K
Sevican	K
Sevilay	K
Sevilcan	K
Sevinay	K
Sevkal	U
Sevkan	U
Sevnaz	K
Sevsay	K
Sevtap	K
Seyda	E
Seyfali	E
Seyfullah	E
Seyhan	U
Seyithan	E
Seyran	U
Seyyal	K
Seyyare	K
Seza	K
Sezai	E
Sezal	U
Sezan	K
Sezay	K
Sezginay	U
Sezginbas	E
Siba	E
Sidal	E
Sidam	E
Sidar	E
Siddika	K
Sidika	K
Sila	U
Silan	E
Siral	E
Siralp	E
Sirat	E
Sirga	K
Sirma	K
Sirmahan	K
Siylihan	E
Sima	K
Simavi	E
Simay	K
Simayisems	K
Simhan	K
Sina	E
Sinan	E
Sincan	K
Sipahi	E
Siracettin	E
Siraç	E
Sirap	K
Sitare	K
Siva	K
Siyavus	E
Solmaz	K
Somay	U
Sonad	E
Sonalp	E
Sonat	U
Sonay	U
Sonbahar	K
Sonbay	E
Sondal	E
Songurhan	E
Songurkan	E
Sontaç	K
Soral	E
Soyak	E
Soyalp	E
Soydan	E
Soydaner	E
Soydas	E
Soyhan	U
Soykal	E
Soykan	U
Soylubay	E
Soysal	E
Soysaldi	E
Soysaltürk	E
Soysan	E
Soyupak	E
Soyurgal	E
Sönmezalp	E
Sönmezay	U
Sözal	E
Sualp	E
Suat	U
Suavi	E
Suay	U
Subasi	E
Subay	E
Subutay	E
Suca	E
Sudan	K
Suhan	E
Suka	E
Sukat	E
Sultan	U
Suna	K
Sunal	E
Sunalp	E
Sunar	U
Sunay	U
Sunguralp	E
Sungurbay	E
Sunullah	E
Suyurgal	E
Suyurgamis	E
Suyurgan	E
Suzan	K
Süalp	E
Sübas	E
Sübasi	E
Sübitay	E
Südas	E
Süeda	K
Süerkan	E
Süersan	E
Süha	E
Sühan	E
Sühandan	K
Sükan	E
Süleyman	E
Sülünay	K
Sümerkan	E
Sümeyra	K
Süngütay	E
Süphan	E
Süreyya	U
Süvari	E
Süveyda	K
Süzülay	K
Sad 	E
Sadan	U
Sader	E
Sadiman	U
Sadi	E
Sadiye	K
Saduman	K
Safak	U
Safaknur	K
Safi	E
Safiye	K
Sah	E
Sahadet	E
Sahadettin	E
Sahamet	U
Sahan	E
Sahane	K
Sahap	E
Sahat	E
Sahbanu	K
Sahbaz	E
Sahbey	E
Sahdane	K
Sahdar	E
Sahende	K
Saheser	K
Sahhanim	K
Sahigül	K
Sahika	K
Sahin	E
Sahinalp	E
Sahinbay	E
Sahinbey	E
Sahiner	E
Sahinhan	E
Sahinkan	E
Sahinter	E
Sahistan	E
Sahittin	E
Sahlan	E
Sahmelek	K
Sahnaz	K
Sahnisa	K
Sahnur	K
Sahruh	E
Sahsinur	K
Sahsüvar	E
Sahvar	K
Sahvelet	E
Sahver	K
Sahzade	E
Sahzat	E
Saik	E
Saika	K
Sair	E
Saire	K
Sakar	U
Sakayik	K
Sakir	E
Sakire	K
Samih	E
Samiha	K
Samil	E
Samile	K
San	U
Sanal	U
Sanalp	E
Saner	E
Sanli	E
Sanlibay	E
Sansal	U
Sansel	K
Sanser	K
Sanver	E
Sar	E
Sarbay	E
Sarik	E
Sarika	K
Satir	E
Sayan	U
Sayegân	K
Sayeste	U
Saylan	U
Sazi	E
Saziment	K
Saziye	K
Sebap	E
Secaat	E
Sefaat	U
Sefaattin	E
Sefika	K
Sefkat	U
Sehadet	E
Sehadettin	E
Sehamet	E
Sehbal	K
Sehinsah	E
Sehnaz	K
Sehrazat	K
Sehriban	K
Sehrinaz	K
Sehsüvar	E
Sehvar	K
Sehzade	E
Sehzat	E
Sekernaz	K
Sekerpare	K
Semail	E
Semsinisa	K
Senal	E
Senalp	E
Senaltan	E
Senay	U
Senbay	E
Sencan	U
Sendag	K
Sendogan	U
Senkal	U
Sensal	E
Senyasar	E
Serafet	E
Serafettin	E
Serefhan	E
Serefnaz	K
Setaret	K
Sevketfeza	K
Sevkinaz	K
Sevval	K
Seyda	U
Seydagül	K
Seydanur	K
Seyma	K
Seyyat	E
Siray	K
Sifa	K
Simsad	E
Simsekhan	E
Simsekkan	E
Sinasi	E
Sinaver	E
Sipal	E
Sirinsah	K
Sirvan	E
Sirzat	E
Suayp	E
Sungar	E
Sükran	U
Tacal	E
Tacettin	E
Tacizer	K
Taci	E
Tacim	E
Tacir	E
Taciser	K
Tacver	E
Taç	U
Taçeser	K
Taçkin	E
Taçli	K
Taçliyildiz	K
Taçnur	K
Taflan	U
Tagan	K
Tagangül	K
Tagay	E
Tag	E
Tagalp	E
Tagar	E
Tagay	E
Tagman	E
Taha	E
Tahir	E
Tahire	K
Tahsin	E
Tahsine	K
Taibe	K
Taip	E
Takdir	E
Taki	E
Takiye	K
Takiyettin	E
Talas	E
Talât	U
Talay	E
Talayer	E
Talayhan	E
Talaykan	E
Talaykoç	E
Talaykurt	E
Talaykut	E
Talayman	E
Talaz	E
Talha	E
Tali	E
Talia	K
Talibe	K
Talih	E
Taliha	K
Talip	E
Taliye	K
Talu	E
Taluy	E
Taluyhan	E
Tamal	E
Tamam	K
Tamar	E
Tamay	U
Tamaydin	E
Tamçelik	E
Tamer	E
Tamerk	E
Tamgül	K
Tamkan	E
Tamkoç	E
Tamkurt	E
Tamkut	E
Tamtürk	E
Tan	U
Tanaçan	E
Tanaçar	E
Tanagar	E
Tanak	E
Tanal	U
Tanalp	E
Tanaltan	E
Tanaltay	E
Tanay	U
Tanaydin	U
Tanbay	E
Tanbek	E
Tanberk	E
Tanbey	E
Tanboga	E
Tanbolat	E
Tancan	E
Tandan	K
Tandogan	E
Tandogdu	E
Tandogmus	E
Tandoruk	E
Tanegül	K
Tanel	E
Tanelgin	K
Taner	U
Tanerk	E
Tanfer	E
Tangör	U
Tangüç	E
Tangül	K
Tangülü	K
Tangün	U
Tangüner	E
Tanhan	E
Tanhatun	K
Tanik	E
Tanin	E
Tanir	E
Tanircan	E
Tanirer	E
Tanis	E
Tanju	U
Tankan	E
Tankoç	E
Tankurt	E
Tankut	U
Tankutlu	E
Tanla	E
Tanlak	E
Tanman	E
Tanören	E
Tanpinar	E
Tanrikorur	E
Tanrikul	E
Tanrikulu	E
Tanriöver	E
Tansal	E
Tansan	E
Tansel	U
Tanseli	K
Tansen	E
Tanser	U
Tanses	K
Tansev	U
Tanseven	E
Tansever	E
Tansi	E
Tansig	E
Tansik	E
Tansoy	E
Tansu	U
Tansug	E
Tansuk	E
Tantug	E
Tantürk	E
Tanugur	E
Tanver	E
Tanyel	U
Tanyeli	U
Tanyer	U
Tanyeri	U
Tanyildiz	U
Tanyol	U
Tanyolaç	E
Tanyolu	U
Tanyu	U
Tanyücel	E
Tanyüz	U
Tanzer	U
Tapduk	E
Tapgaç	E
Tapik	E
Tapinç	E
Tapli	E
Taptuk	E
Taranci	E
Tarçin	K
Tardu	E
Tarduk	E
Targan	E
Tarhan	E
Tarhun	E
Tari	E
Tarik	E
Tarim	U
Tariman	E
Tarimbike	K
Tarimer	E
Tarik	E
Tarkan	E
Tarman	E
Tartis	E
Taru	E
Tasvir	K
Tasan	U
Tasar	E
Tasboga	E
Tasbudak	E
Tascan	E
Tasdemir	E
Tasdöven	E
Tasel	E
Taser	E
Tasgan	E
Tashan	E
Taskan	E
Taskent	E
Taskin	E
Taskinel	E
Taskiner	E
Taskiran	E
Tastan	E
Tastekin	E
Tatar	E
Tatarhan	E
Tatarkan	E
Tatli	K
Tatu	U
Tav	E
Tavgaç	E
Tavlan	E
Tavli	E
Tavus	K
Tavus	E
Tay	E
Taya	K
Tayak	E
Tayanç	E
Tayaydin	E
Taybars	E
Taybek	E
Tayberk	E
Tayboga	E
Taycan	E
Taydas	E
Taydemir	E
Tayfun	E
Tayfur	E
Taygan	E
Taygun	E
Tayguner	E
Tayhan	E
Taykara	E
Taykoç	E
Taykurt	E
Taykut	E
Tayla	E
Taylak	E
Taylan	U
Taylaner	E
Tayman	E
Taymaz	E
Taypars	E
Tayuk	E
Tayyar	E
Tayyibe	K
Tayyip	E
Taze	K
Tazegül	K
Teberdar	E
Tekal	E
Tekalp	E
Tekant	E
Tekay	E
Tekbay	E
Tekcan	E
Tekdogan	E
Tekebas	E
Tekebay	E
Tekecan	E
Tekinal	E
Tekinalp	E
Tekinay	E
Tekindag	E
Tekinhan	E
Tekyay	E
Temirbay	E
Temircan	E
Temirhan	E
Temirkan	E
Temirtas	E
Temizalp	E
Temizcan	E
Temizhan	E
Temizkal	E
Temizkan	E
Temizsan	E
Temürhan	E
Temürsah	E
Tenay	K
Tendübay	E
Tengizalp	E
Teoman	E
Tercan	U
Terlan	E
Tevfika	K
Tevrat	K
Tezal	E
Tezalp	E
Tezay	U
Tezcan	U
Tezcanli	E
Tezkan	U
Tinal	E
Tinaz	E
Tilmaç	E
Timurcan	E
Timurhan	E
Timurkan	E
Timurtas	E
Tiraje	K
Togan	E
Togay	E
Tokal	E
Tokalan	E
Tokalp	E
Tokay	E
Tokcan	E
Tokhan	E
Tokkan	E
Tokta	E
Toktahan	E
Toktamis	E
Toktas	E
Tokushan	E
Tokyay	E
Tola	U
Tolay	E
Tolga	E
Tolgahan	E
Tolgan	E
Tolgay	E
Tolgunay	U
Tolonay	E
Tolonbay	E
Tolunay	E
Tolunbay	E
Tongal	E
Tongar	E
Topa	E
Topaç	E
Topak	E
Topay	U
Topaz	K
Topçam	E
Topçay	E
Toprak	U
Toralp	E
Toraman	E
Toran	E
Torcan	E
Torgay	E
Torhan	E
Torkal	E
Torkan	E
Torlak	E
Torumtay	E
Toyboga	E
Toycan	E
Toygar	E
Toyka	E
Tozan	E
Törehan	E
Tuba	K
Tufan	E
Tugay	E
Tugal	E
Tugalp	E
Tugaltan	E
Tugaltay	E
Tugba	K
Tugbay	E
Tughan	E
Tugkan	E
Tugra	E
Tugsan	E
Tugsav	E
Tugsavas	E
Tugsavul	E
Tugsavun	E
Tugtas	E
Tugtay	E
Tugyan	U
Tulca	K
Tulga	E
Tulgar	E
Tuman	E
Tumay	E
Tuna	U
Tunacan	E
Tunaer	E
Tunahan	U
Tunakan	E
Tunay	E
Tunca	U
Tuncal	E
Tuncalp	E
Tuncay	U
Tunçal	E
Tunçalin	E
Tunçalp	E
Tunçaral	E
Tunçaslan	E
Tunçay	E
Tunçbay	E
Tunçboga	E
Tunççag	E
Tunçhan	E
Tunçkan	E
Tunçkaya	E
Tunçtan	E
Tunga	E
Tura	E
Turaç	U
Tural	E
Turalp	E
Turan	E
Turatekin	E
Turay	E
Turbay	E
Turcan	E
Turfa	K
Turgay	E
Turhan	E
Turhatun	K
Turkan	E
Turna	K
Tutuhan	E
Tuvana	U
Tuyan	E
Tükelalp	E
Tükelay	E
Tülay	K
Tülcan	K
Tülinay	K
Tümay	U
Tümbay	E
Tümcan	U
Tümenbay	E
Tümenboga	E
Tümerkan	E
Tümhan	E
Tümkal	E
Tümkan	E
Tünak	E
Tünal	E
Tünay	U
Tünaydin	U
Türehan	E
Türkalp	E
Türkaslan	E
Türkay	U
Türkcan	E
Türkdogan	E
Türkkan	E
Türksan	E
Türkyilmaz	E
Tüzünalp	E
Tüzünkan	U
Ubeydullah	E
Uca	E
Ucaer	E
Ucatekin	E
Uça	E
Uçan	E
Uçanay	E
Uçanok	E
Uçantekin	E
Uçantürk	E
Uçar	E
Uçarer	E
Uçarli	E
Uçay	E
Uçbay	E
Uçhan	E
Uçkan	E
Uçkara	E
Uçma	E
Uçmak	U
Uçman	E
Uflaz	E
Ufukay	U
Ufuktan	E
Ugan	E
Ugan	U
Uganbike	K
Ugural	E
Uguralp	E
Ugurata	E
Uguray	U
Ugurcan	U
Ugurhan	E
Ugurlubay	E
Ugursal	U
Ugursan	E
Ugursay	E
Ugurtan	U
Ugurtay	E
Ulaç	E
Ulaçhan	E
Ulaçkan	E
Ulak	E
Ulakbey	E
Ulam	E
Ular	E
Ulas	E
Ulcan	E
Ulcay	U
Ulualp	E
Uluant	E
Ulubas	E
Ulubay	E
Uluca	E
Ulucan	E
Uluçag	E
Uluçam	E
Uluçkan	E
Uludag	E
Uludogan	E
Uluerkan	E
Uluhan	E
Ulukaan	E
Ulukan	E
Ulukaya	E
Uluman	E
Ulunay	U
Ulusal	E
Ulusan	E
Ulusahin	E
Ulusan	E
Ulutan	E
Ulutas	E
Ulutay	E
Ulya	K
Uma	E
Umaç	E
Umak	E
Uman	E
Umar	U
Umay	K
Umman	U
Umran	U
Umural	E
Umuralp	E
Umurbay	E
Unan	E
Unat	E
Ungan	E
Ural	E
Uralp	E
Uraltan	E
Uraltay	E
Uram	E
Uran	E
Uras	E
Uraz	E
Uraza	E
Urazli	E
Urhan	E
Urkan	E
Usal	E
Usalan	E
Usalp	E
Usbay	E
Ushan	E
Uskan	E
Usman	E
Usta	E
Usak	E
Utkan	E
Utman	E
Uyar	E
Uyaralp	E
Uyarel	E
Uyarer	E
Uygan	E
Uygar	E
Uyguralp	E
Uysal	U
Uzalp	E
Uzay	U
Uzbay	E
Uzcan	E
Uzhan	E
Uzkan	E
Uzman	E
Uzsan	E
Uztan	E
Uztas	E
Uztav	E
Uztay	E
Übeydullah	E
Üftade	K
Ükkase	E
Ülgenalp	E
Ülkühan	K
Ülkütan	E
Ümmühan	K
Ümran	U
Ünal	U
Ünalan	E
Ünaldi	E
Ünalmis	E
Ünalp	E
Ünay	U
Ünkan	E
Ünkaya	E
Ünsaç	U
Ünsal	U
Ünsan	E
Ünsay	K
Ünüvar	E
Ünyay	E
Ürünay	K
Üründübay	E
Üstat	E
Üstay	E
Üstünbay	E
Vacibe	K
Vacide	K
Vacip	E
Vacit	E
Vafi	E
Vafir	E
Vafit	E
Vaha	E
Vahap	E
Vahdet	E
Vahdettin	E
Vahibe	K
Vahide	K
Vahip	E
Vahit	E
Vahittin	E
Vaiz	E
Vakkas	E
Vakur	E
Vâlâsan	E
Valide	K
Vamik	E
Vamika	K
Varal	E
Varas	E
Vardar	E
Vargin	E
Varlik	U
Varol	E
Vasfi	E
Vasfiye	K
Vasif	E
Vasil	E
Vasila	K
Vassaf	E
Vatan	E
Vataner	E
Vecahet	K
Vecahettin	E
Veciha	K
Veda	K
Vedat	E
Vedia	K
Vefa	U
Vefai	E
Vefakâr	K
Vefia	K
Vefika	K
Velican	E
Veliyullah	E
Veral	E
Verda	K
Verdinaz	K
Versan	E
Vesamet	U
Vicdan	U
Vicdani	E
Vildan	K
Visali	E
Visam	E
Volkan	E
Vural	E
Vuslat	K
Yada	U
Yadaci	E
Yadigâr	U
Yafes	E
Yagan	U
Yagin	E
Yaginalp	E
Yagisiyan	E
Yagis	K
Yagiz	E
Yagizalp	E
Yagizbay	E
Yagizboga	E
Yagizer	E
Yagizhan	E
Yagizkan	E
Yagizkurt	E
Yagiztekin	E
Yagmanaz	K
Yagmur	U
Yagmurca	E
Yahsi	U
Yahsibay	E
Yahsiboga	E
Yahsihan	E
Yahsikan	E
Yahsitay	E
Yahya	E
Yakup	E
Yakut	U
Yalap	E
Yalav	U
Yalavaç	E
Yalaz	E
Yalaza	K
Yalazahan	E
Yalazakan	E
Yalazalp	E
Yalazan	U
Yalazay	U
Yalçin	E
Yalçiner	E
Yalçinkaya	E
Yalçuk	U
Yaldirak	E
Yaldirim	E
Yaldiz	K
Yalgi	E
Yalgin	E
Yalginay	E
Yalim	E
Yalin	U
Yalinalp	E
Yalinay	U
Yalki	E
Yalkin	E
Yalmaç	E
Yalman	E
Yalt	E
Yaltir	E
Yaltirak	U
Yaltiray	U
Yalvaç	E
Yamaç	E
Yaman	E
Yamaner	E
Yamanöz	E
Yamansoy	E
Yamantürk	E
Yamanyigit	E
Yamçi	E
Yanaç	E
Yanal	E
Yanar	E
Yanbek	E
Yanbey	E
Yandil	E
Yangâr	E
Yanik	E
Yaniker	E
Yanki	U
Yapalak	E
Yapincak	K
Yaprak	K
Yararer	E
Yarasik	U
Yârcan	K
Yardak	E
Yargan	E
Yargi	E
Yarkan	E
Yarkaya	E
Yarkin	U
Yarlik	E
Yarluk	E
Yarpuz	K
Yaruk	E
Yasa	E
Yasan	E
Yasavul	E
Yasemin	K
Yaser	E
Yasin	E
Yasun	E
Yasa	E
Yasam	U
Yasanur	U
Yasar	U
Yasartürk	E
Yasdas	E
Yasik	U
Yasil	K
Yasin	U
Yasiyan	K
Yaslak	E
Yatman	E
Yatuk	E
Yavas	E
Yaver	E
Yavuz	E
Yavuzalp	E
Yavuzay	E
Yavuzbay	E
Yavuzboga	E
Yavuzcan	E
Yavuzer	E
Yavuzhan	E
Yavuzsoy	E
Yay	E
Yayak	E
Yayalp	E
Yaybörü	E
Yaybüke	E
Yaygir	E
Yayla	U
Yaylagül	K
Yaylak	E
Yazan	E
Yazar	E
Yazgan	E
Yazganalp	E
Yazgi	E
Yazgül	K
Yazgülü	K
Yazik	E
Yazir	E
Yekta	U
Yelal	E
Yelbay	E
Yelboga	E
Yelda	K
Yeldan	E
Yenal	E
Yenay	E
Yeneral	E
Yertan	E
Yesari	E
Yetisal	E
Yezdan	E
Yibar	E
Yilay	K
Yilbay	E
Yildanur	K
Yildiralp	E
Yildiran	E
Yildiraner	E
Yildiray	E
Yildizhan	U
Yilhan	E
Yilkan	E
Yilma	E
Yilmaz	E
Yilmazok	E
Yipar	U
Yigitcan	E
Yigithan	E
Yigitkan	E
Yinanç	E
Yogunay	E
Yola	E
Yolaç	E
Yolal	E
Yoldas	E
Yoma	E
Yonca	K
Yordam	E
Yordamli	E
Yosma	K
Yönal	U
Yula	E
Yura	E
Yurdaal	K
Yurdaay	E
Yurdacan	E
Yurdaer	E
Yurdagül	K
Yurdakul	U
Yurdal	E
Yurdanur	U
Yurdaser	K
Yurdasen	U
Yurdatap	K
Yurday	K
Yurtal	E
Yurtbay	E
Yurtcan	E
Yurtkuran	E
Yurtman	E
Yurtsal	E
Yurtsan	U
Yurtsay	K
Yurttas	E
Yücealp	E
Yücebas	E
Yücedag	E
Yücelay	E
Yücesan	E
Yüzüak	E
Zade	E
Zafer	U
Zafir	E
Zafire	K
Zagnos	E
Zahide	K
Zahir	E
Zahire	K
Zahit	E
Zaide	K
Zaik	E
Zaika	K
Zaim	E
Zait	E
Zaki	E
Zakir	E
Zakire	K
Zaman	E
Zambak	K
Zamir	E
Zamire	K
Zarif	U
Zarife	K
Zati	E
Zatinur	K
Zatiye	K
Zehra	K
Zekeriya	E
Zeliha	K
Zennisan	K
Zerafet	K
Zerefsan	K
Zeria	K
Zernisan	K
Zerrintaç	K
Zeycan	E
Zeynullah	E
Zeyyat	E
Ziba  	K
Zican	K
Zikrullah	E
Zisan	U
Ziya	E
Ziyaeddin	E
Ziyaettin	E
Ziyafet	K
Ziyat	E
Ziynetullah	E
Zoral	E
Zuhal	K
Zühal	K
Züleyha	K
Zülfibar	K
Zülfikar	E
Zülfiyar	K
Zülfizar	K
Zülfübar	K
Zülfüyar	K
Zülfüzar	K
Zülkarneyn	E
Zümra	K
Bâhir	E
Bâhire	K
Bedel	E
Beder	K
Bedi	E
Bedih	E
Bedihe	K
Bedir	E
Bedis	K
Bediz	U
Bedrettin	E
Bedri	E
Bedriye	K
Bedük	E
Begim	K
Begüm	K
Begenç	E
Behçet	E
Behice	K
Behiç	E
Behin	K
Behire	K
Behiye	K
Behlül	E
Behmen	E
Bek	E
Bekâm	E
Bekdemir	E
Bekdil	E
Bekem	E
Beken	K
Beker	E
Bekir	E
Bektöre	E
Bektürk	E
Belek	E
Belen	E
Belge	E
Belgi	K
Belgin	K
Belig	E
Belik	K
Belin	K
Beliz	K
Belkis	K
Bellek	E
Belmen	K
Bender	E
Bendes	E
Benek	K
Bener	E
Benevse	K
Bengi	U
Bengigül	K
Bengisoy	E
Bengisu	U
Bengü	U
Bengül	K
Benice	K
Benli	K
Benligül	K
Bennur	K
Benol	E
Bensu	K
Bensen	U
Bent	E
Bentürk	E
Benzer	E
Berceste	K
Bercis	K
Bereket	U
Beren	U
Berfin	U
Berfu	K
Berge	E
Bergin	E
Beri	E
Berin	U
Beriye	K
Berk	E
Berke	U
Berkel	E
Berker	E
Berki	E
Berkin	E
Berkiye	K
Berkmen	E
Berkok	E
Berkol	E
Berköz	E
Berksoy	E
Berksu	E
Berksun	E
Berktin	E
Berkün	E
Bermude	K
Berrin	K
Berse	K
Berter	E
Besen	U
Besim	E
Besime	K
Beste	K
Bestegül	K
Beser	E
Besgül	K
Besir	E
Besire	K
Betigül	K
Betik	U
Betil	K
Betim	E
Betül	K
Beygu	E
Beylem	K
Beyrek	E
Beysun	K
Beytekin	E
Beytemir	E
Beytöre	E
Bezek	K
Bezen	K
Bezmiâlem	K
Bige	K
Bigüm	K
Bihin	K
Bihine	K
Bihter	K
Bihterin	K
Bike	K
Bilâl	E
Bilek	E
Bilen	U
Bilender	E
Bilge	U
Bilgeer	E
Bilgekurt	E
Bilgekut	E
Bilgen	U
Bilgenur	K
Bilger	E
Bilgetürk	E
Bilgi	U
Bilgiç	E
Bilgin	E
Bilginer	E
Bilginur	K
Bilgiser	K
Bilgü	E
Bilgün	K
Bilik	E
Bilir	U
Bilis	K
Billûr	K
Bilmen	E
Bilnur	E
Bilsen	U
Bilsev	K
Bilsin	K
Biner	E
Bingöl	E
Bingül	K
Bingün	K
Binisik	E
Biniz	K
Binnur	U
Bintug	E
Binzet	K
Birben	K
Birbenek	K
Birce	U
Birçek	K
Birge	U
Birgen	K
Birgi	E
Birgit	E
Birgül	K
Birgün	K
Biricik	K
Birim	K
Biriz	U
Birke	K
Birkök	E
Birmen	E
Birnur	K
Birol	E
Birsel	U
Birsen	U
Birsin	E
Birsoy	E
Birsen	E
Birtek	K
Birten	E
Bitek	E
Bitengül	K
Bitim	E
Boncuk	K
Bor	E
Boy	E
Boyer	E
Boylu	E
Boz	E
Bozbey	E
Bozçin	K
Bozdemir	E
Bozdeniz	E
Bozer	E
Bozerk	E
Bozkir	E
Bozkurt	E
Bozok	E
Boztepe	E
Boztimur	E
Bozyel	E
Bozyigit	E
Böget	E
Bögrek	E
Bögürtlen	K
Böke	E
Böken	E
Börçek	E
Börk	E
Börteçin	E
Börü	E
Börübey	E
Budun	E
Bugül	K
Buket	K
Bulgu	E
Buluç	E
Bulunç	E
Bulus	U
Bulut	E
Buluttekin	E
Bumin	E
Burcu	K
Burç	E
Burçin	U
Buruk	E
Buruktekin	E
Buse	K
Buyruk	E
Buyrukçu	E
Büge	U
Büget	E
Bügdüz	E
Bük	E
Büke	U
Büklüm	U
Bülbül	K
Bülent	E
Bürçe	E
Bürçin	K
Bürge	U
Bürgü	K
Bürküt	E
Bürümcek	K
Büte	K
Bütün	U
Cebe	E
Ceben	E
Cebesoy	E
Çeber	E
Çelebi	E
Çelikbilek	E
Çitlembik	K
Çölbey	E
Demirbüken	E
Dilbent	K
Dilber	K
Dilbeste	K
Dilbu	K
Dudubikem	K
Ebecen	E
Ebed	E
Ebet	E
Ebru	K
Ebubekir	E
Ecebey	E
Edibe	K
Ekber	E
Elbek	E
Elbeyi	E
Elbirle	K
Elbirlik	K
Elçibey	E
Elibol	E
Erbelgin	E
Erben	E
Erberk	E
Erbey	E
Erbil	U
Erbilek	E
Erbilen	E
Erbilir	E
Erboy	E
Erdibek	E
Erdibey	E
Erdibike	K
Erdibikem	K
Eribe	K
Feribe	K
Gökbel	E
Gökbelen	E
Gökben	K
Gökberk	E
Gökbey	E
Gökbörü	E
Gökbudun	E
Gökbulut	E
Gökçebel	E
Gökçebey	E
Görbil	E
Gurbet	K
Gülbeden	K
Gülbek	E
Gülben	K
Gülbende	K
Gülbeniz	K
Gülberk	K
Gülbeseker	K
Gülbey	E
Gülbeyi	E
Gülbike	K
Gülbikem	K
Gülbil	K
Gülbin	K
Gülbitti	K
Gülbiz	K
Gülboy	K
Gülbu	K
Gülbün	K
Gülbüz	K
Gülebetin	K
Gülengübin	K
Gülpembe	K
Gümberk	E
Günbek	E
Günbey	E
Gündüzbey	E
Güngörbey	E
Gürbüz	U
Heybet	E
Hürbey	E
Isinbike	K
Ibik	E
Ibili	K
Ibis	E
Ibo	E
Içimbike	K
Ilbeg	E
Ilbek	E
Ilbey	E
Ilbeyi	E
Ilbike	K
Ilbilge	U
Ilbozdu	E
Ilbudun	E
Incebey	E
Isenbike	K
Izbörü	E
Izbudun	E
Izbul	E
Kâtibe	K
Kebir	E
Kebire	K
Kebuter	K
Kelebek	K
Kirbörü	E
Kizginbey	E
Kizilbörü	E
Kiçkinebike	K
Koçbörü	E
Koçubey	E
Konurbey	E
Kutbiye	K
Lebibe	K
Lebip	E
Lebriz	K
Mebruk	E
Mebruke	K
Mebrur	E
Mebrure	K
Mebus	E
Mebuse	K
Mengüberti	E
Mergube	K
Mevhibe	K
Muhibbe	K
Muhibbi	E
Mukbil	E
Mukbile	K
Mustubey	E
Muteber	U
Mübeccel	K
Mübeyyen	K
Mübin	E
Mübine	K
Mühibe	K
Münibe	K
Nebi	E
Nebih	E
Nebihe	K
Nebil	E
Nebile	K
Nebiye	K
Necibe	K
Nesibe	K
Nevber	K
Nilberk	K
Nuhbe	K
Nurben	K
Nurbige	K
Oben	E
Obuz	E
Ogulbey	E
Okbudun	E
Orbek	E
Öbek	E
Ölmezbey	E
Özbek	U
Özben	U
Özberk	E
Özbey	E
Özbil	U
Özbilek	U
Özbilen	U
Özbilge	U
Özbilgin	E
Özbilir	U
Özbir	E
Özcebe	E
Pembe	K
Pembegül	K
Rebi	E
Rebii	E
Rebiyye	K
Rehber	E
Sebih	E
Sebil	U
Sebile	K
Seblâ	K
Sebu	K
Sebük	E
Sebüktekin	E
Serbülent	E
Sibel	K
Simber	K
Soylubey	E
Subegi	E
Subhi	E
Subhiye	K
Sulbiye	K
Sülünbike	K
Sümbül	K
Sümbülves	K
Sünbüle	K
Sebnem	K
Sebnur	K
Sekibe	K
Serbet	K
Sirinbegim	K
Sirinbige	K
Teber	E
Teberhun	E
Teberrük	K
Tebessüm	K
Tebrik	E
Tekbek	E
Tekbey	E
Tekbir	E
Tekebey	E
Tellibey	E
Tibet	E
Tilbe	K
Tolunbike	K
Tosunbey	E
Tunçbilek	E
Tunçbörü	E
Tüblek	E
Ubeyde	K
Ubeyt	E
Uçbeyi	E
Ugurlubey	E
Ulubek	E
Uluberk	E
Ulubey	E
Ulugbey	E
Umurbey	E
Urbeyi	E
Usberk	E
Usbey	E
Usunbike	K
Übeyd	E
Übeyde	K
Übeyt	E
Übük	K
Ünübol	U
Vecibe	K
Vehbi	E
Vehbiye	K
Yolbul	E
Zebercet	K
Zobu	E
Zorbey	E
Zübeyde	K
Zübeyr	E
Cedide	K
Celâdet	E
Celâl	E
Celâlettin	E
Celâli	E
Celâsun	E
Celâyir	E
Celil	E
Celile	K
Cem	E
Cemi	E
Cemil	E
Cemile	K
Ceminur	K
Cemre	U
Cemsir	E
Cemsit	E
Cengâver	E
Cenger	E
Cengiz	E
Cenk	E
Cenker	E
Cennet	K
Ceren	K
Cerit	E
Cesim	E
Cesur	E
Cevdet	E
Cevher	U
Cevheri	E
Cevri	E
Cevriye	K
Ceyhun	U
Ceylân	K
Cezlân	E
Cezmi	E
Cilvekâr	K
Cimsit	E
Cindoruk	E
Cosku	E
Coskun	E
Coskuner	E
Coskunsu	E
Cömert	E
Cuci	E
Cudi	E
Cudiye	K
Culduz	E
Cumhur	E
Cumhuriyet	E
Cündi	E
Cüneyt	E
Delice	E
Dicle	K
Domurcuk	K
Ece	U
Ecegül	K
Ecemis	E
Ecenur	K
Ecer	U
Ecevit	E
Ecir	E
Ecmel	U
Ecvet	E
Ekinci	E
Emcet	E
Erce	E
Erciyes	E
Ercüment	E
Erincek	E
Erincik	E
Evcil	U
Evcimen	U
Evecen	K
Fecir	K
Fecri	E
Fecriye	K
Gelincik	K
Gence	E
Gencel	E
Gencer	E
Genco	E
Gonce	K
Göcek	E
Gökcen	U
Gücel	E
Gücer	E
Gücümen	E
Gülce	K
Gülece	K
Gülinci	K
Güvercin	K
Güzelce	K
Hicret	U
Huceste	K
Hüccet	E
Hüceste	K
Iclâl	K
Imece	K
Ince	U
Incesu	E
Inci	K
Inciden	K
Incifem	K
Incifer	K
Incigül	K
Incilâ	K
Incilây	K
Incinur	K
Incisel	K
Inciser	K
Ivecen	E
Iyicil	E
Kivilcim	U
Korucu	E
Mecdi	E
Mecdut	E
Mecide	K
Mecit	E
Mecittin	E
Mecnun	E
Mehcur	E
Mehcure	K
Mengücek	E
Mescur	E
Mevcude	K
Mevcut	E
Mucide	K
Mucip	E
Mucit	E
Mucize	K
Müceddet	K
Mücellâ	K
Mücessem	K
Mücevher	K
Münci	E
Münciye	K
Necdet	E
Necile	K
Necip	E
Neclâ	K
Necmi	E
Necmiye	K
Necve	K
Netice	K
Öncel	U
Öncü	E
Öncüer	E
Özgeci	E
Recep	E
Selcen	U
Sencer	E
Tecelli	U
Tecen	E
Tecer	U
Teceren	E
Tecim	E
Tecimen	E
Tecimer	E
Tecir	E
Ticen	K
Tomurcuk	K
Tugcu	E
Tuncel	E
Tuncer	E
Ülkücü	E
Vecdet	E
Vecdi	E
Vechi	E
Vechiye	K
Vecih	E
Vecihe	K
Vecihi	E
Vecit	E
Yüce	U
Yüceer	E
Yücel	U
Yücelen	U
Yücelt	E
Yücelten	E
Yücenur	K
Yücesoy	E
Yücetekin	E
Yücetürk	E
Çeçen	E
Çekik	E
Çekim	E
Çekin	E
Çelem	E
Çelen	E
Çelenk	E
Çelik	E
Çelikel	E
Çeliker	E
Çelikiz	E
Çelikkol	E
Çeliköz	E
Çeliksu	E
Çelikten	E
Çeliktürk	E
Çelikyürek	E
Çelim	E
Çeltik	E
Çender	E
Çengiz	E
Çepni	E
Çerçi	E
Çeri	E
Çerkez	E
Çerme	E
Çetik	E
Çetin	E
Çetinel	E
Çetiner	E
Çetinok	E
Çetinöz	E
Çetinsoy	E
Çetinsu	E
Çetintürk	E
Çetinyigit	E
Çevik	E
Çevikel	E
Çeviker	E
Çeviköz	E
Çevrim	E
Çeyiz	K
Çig	E
Çigil	E
Çigir	U
Çingi	E
Çivgin	E
Çiçek	K
Çiftçi	E
Çigdem	K
Çigil	E
Çiglez	E
Çilek	K
Çilen	K
Çilenti	K
Çiler	K
Çimen	K
Çin 	E
Çinel	U
Çiner	E
Çinerk	E
Çingiz	E
Çinkiliç	E
Çinuçin	E
Çisen	K
Çisil	K
Çoker	E
Çoku	E
Çopur	E
Çotuk	E
Çotur	E
Çökermis	E
Çöyür	E
Demirgüç	E
Demirkoç	E
Demirpençe	E
Dikeç	E
Dinç	E
Dinçel	U
Dinçer	E
Dinçerk	E
Dinçkol	E
Dinçkök	E
Dinçmen	E
Dinçok	E
Dinçol	E
Dinçöz	E
Dinçsel	E
Dinçsoy	E
Dinçsü	E
Dinçtürk	E
Direnç	E
Elçi	E
Elçim	K
Elçin	U
Emeç	E
Enç	E
Eneç	E
Erçelik	E
Erçetin	E
Erçevik	E
Erçil	K
Erdinç	E
Erengüç	E
Ergenç	E
Ergüç	E
Ergüleç	E
Ergüvenç	E
Erinç	U
Erinçer	E
Erkiliç	E
Erkoç	E
Erseç	E
Ersevinç	E
Ertunç	E
Fereç	E
Genç	E
Gençel	E
Gençer	E
Gençsoy	E
Gençsu	E
Gençtürk	E
Gerçek	E
Gerçeker	E
Girginkoç	E
Göçen	E
Göçer	E
Göçmen	E
Gögünç	K
Gökçe	U
Gökçeer	E
Gökçek	U
Gökçel	U
Gökçem	K
Gökçen	U
Gökçer	E
Gökçesu	E
Gökçil	E
Gökçin	U
Gökçül	E
Gökçün	E
Göktunç	E
Gönç	E
Gönenç	U
Görgüç	E
Göyünç	E
Gözenç	K
Güç	E
Güçel	E
Güçeren	E
Güçermis	E
Güçlü	E
Güçlüer	E
Güçlütürk	E
Güçmen	E
Güçsel	E
Güçyener	E
Güçyeter	E
Gülçe	K
Gülçehre	K
Gülçiçek	K
Gülçimen	K
Gülçin	K
Gülçün	K
Güleç	U
Güleçer	E
Gümeç	E
Günçe	E
Günçiçegi	K
Günçiçek	K
Güneç	E
Güvenç	U
Hiçsönmez	E
Içim	K
Içli	U
Içöz	E
Içten	U
Ilçi	E
Ilginç	E
Kiliç	E
Kiliçel	E
Kiliçer	E
Kilinç	E
Kirçiçek	K
Kiziltunç	E
Kiçi	E
Koç	E
Koçer	E
Koçsoy	E
Koçtug	E
Koçtürk	E
Koçu	E
Koçyigit	E
Konçuy	K
Köçeri	E
Lâçin	E
Mehmetçik	E
Mengüç	E
Meriç	U
Nurçin	K
Okçun	E
Okgüç	E
Okgüçlü	E
Oktunç	E
Olçun	E
Opçin	E
Orçun	E
Ortunç	E
Oruç	E
Oytunç	E
Ögrünç	E
Ögünç	E
Ölçüm	E
Ölçün	E
Öndünç	E
Öveç	E
Övgünç	K
Övünç	U
Özçelik	E
Özçevik	E
Özçin	E
Özdinç	E
Özdinçer	E
Özenç	U
Özerdinç	E
Özerinç	E
Özgenç	E
Özgüç	E
Özgüleç	E
Özkoç	E
Özokçu	E
Öztunç	E
Perçem	K
Periçehre	K
Pürçek	K
Seçen	E
Seçgül	K
Seçik	K
Seçil	K
Seçim	E
Seçkin	U
Seçkiner	E
Seçme	E
Seçmeer	E
Seçmen	E
Seçmener	E
Selçuk	U
Selçuker	E
Selgüç	E
Serdengeçti	E
Serdinç	E
Sevinç	U
Sonuç	U
Sorguç	E
Soydinç	E
Soydinçer	E
Soyselçuk	E
Tekçe	E
Temuçin	E
Timuçin	E
Tonguç	E
Tugçe	K
Tunç	E
Tunçdemir	E
Tunçel	E
Tunçer	E
Tunçkiliç	E
Tunçkol	E
Tunçkurt	E
Tunçok	E
Tunçöven	E
Tunçsoy	E
Tunçtürk	E
Tunguç	E
Tümkoç	E
Uç	E
Uçkun	U
Uçuk	E
Uçur	U
Uluç	E
Ulumeriç	E
Üçe	E
Üçel	U
Üçer	E
Üçgül	K
Üçisik	U
Üçkök	E
Üçok	E
Üçük	E
Ünüçok	E
Yoruç	E
Âdem	E
Dâhi	E
Dânâ	E
Dede	E
Define	K
Defne	K
Deger	U
Degmeer	E
Dehri	E
Delâl	E
Demet	K
Demhos	K
Demir	E
Demirdelen	E
Demirdöven	E
Demirel	E
Demirer	E
Demirezen	E
Demirgülle	E
Demiriz	E
Demirkol	E
Demirkök	E
Demirkurt	E
Demirkut	E
Demirok	E
Demirol	E
Demiröz	E
Demirsoy	E
Demirtekin	E
Demirtug	E
Demirtürk	E
Demiryürek	E
Demren	E
Dengiz	E
Dengizer	E
Deniz	U
Denizel	E
Denizer	E
Denizmen	E
Deniztekin	E
Denk	E
Denkel	E
Denker	E
Denli	E
Denlisoy	E
Deren	U
Derenel	E
Derin	U
Derinkök	E
Derinöz	E
Derlen	E
Dervis	E
Deste	K
Destegül	K
Devin	U
Deviner	E
Devlet	U
Devlettin	E
Devrim	U
Devrimer	E
Didem	K
Didim	E
Dik	E
Dikel	E
Diken	E
Diker	E
Dikey	E
Dikmen	U
Diksoy	E
Dil	E
Dilâ	K
Dilân	K
Dilâsup	K
Dilâver	E
Dilderen	K
Dilefruz	K
Dilege	K
Dilek	K
Dilem	K
Dilemre	E
Diler	U
Dilfigâr	K
Dilfiruz	K
Dilge	U
Dilhun	K
Dilhus	K
Dilmen	U
Dilnisin	K
Dilnur	K
Dilsuz	K
Dilsen	K
Dilsikâr	K
Dilyâr	E
Diren	E
Diri	E
Dirik	E
Diriker	E
Dirikök	E
Diril	E
Dirim	E
Dirimtekin	E
Dirin	E
Diriner	E
Dirisoy	E
Dirlik	U
Dogru	E
Dogruel	E
Dogruer	E
Dogruol	E
Dogruöz	E
Dogu	U
Doguer	E
Dogus	E
Dolun	U
Doru	E
Doruk	E
Dorukkurt	E
Dorukkut	E
Doruktekin	E
Doruktepe	E
Dost	E
Dölek	E
Dölen	U
Dölensoy	E
Döndü	K
Döne	K
Dönmez	E
Dönmezer	E
Dönmezsoy	E
Dönmeztekin	E
Dönü	E
Dönüs	K
Dudu	K
Duhter	K
Dumlu	E
Dumrul	E
Durdu	U
Durgun	E
Durguner	E
Durgunsu	E
Durkiz	K
Durmus	E
Dursun	E
Dursune	K
Dursen	E
Duru	U
Durugül	K
Duruiz	E
Duruk	E
Durul	E
Duruöz	E
Durusel	E
Durusoy	E
Durusu	E
Durutekin	E
Durutürk	E
Dusize	K
Duygu	U
Duygun	K
Duyu	E
Dülge	E
Dülger	E
Düri	K
Düriye	K
Dürnev	K
Dürri	E
Düsün	E
Düsünsel	E
Düzel	E
Düzey	E
Düzgün	E
Ede	E
Edgü	E
Edgüer	E
Edhem	E
Edip	E
Edis	K
Ediz	U
Efendi	E
Efgende	E
Ehed	E
Ejder	E
Eldem	U
Eldemir	E
Elidemir	E
Elverdi	E
Ender	U
Erdem	E
Erdemer	E
Erdemir	E
Erdemli	E
Erden	U
Erdener	E
Erdeniz	E
Erdesir	E
Erdi	U
Erdil	E
Erdilek	E
Erdin	E
Erdiner	E
Erdog	E
Erdogdu	E
Erdogmus	E
Erdöl	E
Erdölek	E
Erdönmez	E
Erdur	E
Erdurdu	E
Erdurmus	E
Erdursun	E
Erduru	E
Erendemir	E
Erendiz	U
Ergüden	E
Ergüder	E
Eryildiz	E
Esendemir	E
Evdegül	K
Ferdi	E
Ferdiye	K
Ferhunde	K
Feride	K
Feridun	E
Fermude	K
Ferzend	E
Fide	K
Firdevs	K
Firdevsi	E
Füruzende	K
Gedik	E
Gediz	U
Gökdemir	E
Gökdeniz	E
Göndem	E
Gönder	E
Gönülden	K
Gönüldes	E
Gözde	K
Güdek	E
Güder	E
Güldeger	K
Güldehen	K
Güldem	K
Güldemet	K
Gülden	K
Güldeniz	K
Güldenur	K
Gülder	K
Gülderen	K
Güldermis	K
Güldeste	K
Güldilek	K
Güldöne	K
Güldüren	K
Gülender	K
Gülfide	K
Gündemir	E
Günden	U
Gündeniz	E
Günder	E
Gündes	E
Gündogdu	E
Gündogmus	E
Gündöndü	E
Gündüz	U
Güngördü	E
Güzide	K
Hediye	K
Hemdem	E
Hidir	E
Hurside	K
Idik	E
Idikut	E
Ildir	U
Ildiz	U
Idi	E
Idikurt	E
Idikut	E
Idil	K
Idris	E
Igdemir	E
Ildem	E
Ildemer	E
Ildemir	E
Ilden	K
Ildeniz	U
Ildes	U
Iskender	E
Isgüden	E
Isgüder	E
Jülide	K
Kizildemir	E
Kuddus	E
Kuddusi	E
Kudret	U
Kudsiye	K
Ledün	E
Medeni	E
Medet	E
Medide	K
Medih	E
Medine	K
Medit	E
Mehdi	E
Mehdiye	K
Melodi	K
Memduh	E
Menderes	E
Merdi	E
Mesude	K
Mevdut	E
Mevlide	K
Mevlûde	K
Mevlüde	K
Mezide	K
Muktedir	E
Muslihiddin	E
Müderris	E
Müdrik	E
Müdrike	K
Müeddep	K
Müfide	K
Müjde	K
Müldür	E
Müride	K
Mürside	K
Müveddet	K
Nedim	E
Nedime	K
Nedret	U
Neside	K
Nevide	K
Nurdide	K
Nurdil	K
Nurdogdu	K
Nurfide	K
Nüvide	K
Od	E
Oder	E
Okdemir	E
Okverdi	E
Orkide	K
Ödül	U
Önder	U
Önderol	E
Öndes	E
Öründü	E
Özdeger	E
Özdek	E
Özdel	E
Özdemir	E
Özden	U
Özdener	U
Özderen	K
Özdes	U
Özdil	E
Özdilek	U
Özdogdu	E
Özdogmus	E
Özdogru	E
Özdoru	E
Özdoruk	E
Özdurdu	E
Özduru	E
Özdurul	E
Özdurum	E
Özender	E
Özerdem	E
Özerdim	E
Özönder	E
Özüdogru	E
Özverdi	E
Pekdeger	K
Peride	K
Remide	K
Reside	K
Reside	K
Resididdin	E
Rüveyde	K
Rüvide	K
Sedef	K
Seden	K
Sedit	E
Semender	E
Serdil	K
Sevde	K
Sevdiye	K
Sevgideger	E
Sevindik	E
Seydi	E
Seyyide	K
Siddik	E
Sidki	E
Sidkiye	K
Sidre	K
Simden	K
Sude	K
Sudi	E
Sudiye	K
Suudi	E
Suzidil	K
Süerdem	E
Süerden	E
Sündüs	K
Süveyde	K
Semdin	E
Sendeniz	K
Sendil	K
Sendur	E
Sengeldi	U
Sermende	K
Sevkidil	K
Side	E
Tedü	E
Tendü	U
Tendürek	E
Tepedelen	E
Tevhiddin	E
Tevhide	K
Tokdemir	E
Topdemir	E
Toydemir	E
Toydeniz	E
Tümerdem	E
Türkdogdu	E
Ufukdeniz	E
Uldiz	E
Umdu	E
Urundu	E
Ülküdes	U
Üngördü	E
Ünüdeger	E
Ünverdi	E
Üründü	E
Vedi	E
Vedide	K
Vedit	E
Velide	K
Veliyüddin	E
Verdî	E
Yâridil	K
Yedier	E
Yediger	E
Yediveren	K
Yildiku	K
Yildir	E
Yildirer	E
Yildirim	E
Yildiz	K
Yurdum	K
Yurdusev	U
Yurdusen	E
Zeyneddin	E
Zühdi	E
Âlem	E
Âsiye	K
Âtike	K
Âtiye	K
Âzime	K
Efe	E
Efgen	E
Efkâr	E
Eflâtun	U
Efruz	E
Efser	U
Efsun	K
Ege	U
Egemen	U
Egenur	K
Egesel	E
Egilmez	E
Egrek	E
Ehil	K
Ehlimen	E
Eke	E
Ekemen	E
Eken	E
Ekenel	E
Ekener	E
Ekim	U
Ekin	U
Ekiner	E
Ekmel	E
Ekrem	E
Elâ	K
Elânur	K
Elgin	U
Elif	K
Elife	K
Elik	K
Elitez	E
Eliuz	E
Eliüstün	E
Elöve	E
Elöver	E
Elver	E
Elveren	E
Emek	U
Emel	K
Emet	E
Emin	E
Emine	K
Eminel	E
Emir	E
Emos	K
Emre	E
Emri	E
Emriye	K
Ener	E
Eneren	E
Energin	E
Enes	E
Enfes	K
Engin	U
Enginel	E
Enginer	E
Enginiz	U
Enginsoy	E
Enginsu	U
Engiz	E
Engür	E
Enis	E
Enise	K
Enmutlu	E
Enver	E
Er	E
Erek	E
Ereken	E
Erel	U
Erem	U
Eren	U
Erenel	E
Erengül	K
Erengün	K
Erenler	E
Erenöz	E
Erensoy	E
Erensü	E
Erentürk	E
Erenulug	E
Erer	E
Erge	K
Ergem	K
Ergen	E
Ergenekon	E
Ergener	E
Ergi	E
Ergil	E
Ergin	E
Erginel	E
Erginer	E
Erginsoy	E
Ergintug	E
Ergök	E
Ergökmen	E
Ergönen	E
Ergönül	E
Ergör	E
Ergun	E
Erguner	E
Ergül	U
Ergülen	U
Ergüler	U
Ergümen	E
Ergün	U
Ergüner	E
Ergünes	E
Ergüney	E
Ergüven	E
Erhun	E
Erisik	E
Erik	E
Eriker	E
Erim	U
Erimel	E
Erimer	E
Erin	U
Erip	E
Eripek	E
Eris	U
Erisen	K
Eriskin	E
Eriz	E
Erk	E
Erke	U
Erkel	E
Erker	E
Erkin	E
Erkinel	E
Erkis	E
Erkin	U
Erkinel	E
Erkiner	E
Erkmen	E
Erkmenol	E
Erkol	E
Erksoy	E
Erksun	E
Erktin	E
Erkul	E
Erkunt	E
Erkurt	E
Erkus	E
Erkut	E
Erkutlu	E
Erlik	E
Ermis	E
Ermiye	K
Ermutlu	E
Ernur	E
Eroglu	E
Erogul	E
Eroguz	E
Erol	E
Eröge	E
Eröz	E
Ersel	E
Ersen	E
Erserim	E
Ersev	E
Erseven	E
Ersever	E
Ersevin	E
Ersezen	E
Ersezer	E
Ersin	E
Erson	E
Ersoy	E
Ersöz	E
Ersu	E
Ersun	E
Ersü	E
Ersen	E
Erset	E
Erte	E
Ertek	E
Erteke	E
Ertekin	E
Ertem	E
Erten	U
Ertim	E
Ertin	E
Ertingü	E
Ertok	E
Ertop	E
Ertöre	E
Ertug	E
Ertugrul	E
Ertut	E
Ertün	E
Ertüre	E
Ertürk	E
Ertüze	E
Ertüzün	E
Erülgen	E
Erün	E
Erüstün	E
Ervin	K
Eryetis	E
Eryigit	E
Erzi	E
Ese	E
Esen	U
Esenel	E
Esener	E
Esengül	K
Esengün	K
Esenkul	E
Esentimur	E
Esentürk	E
Eser	U
Esergül	K
Esim	U
Esin	U
Esiner	E
Eskin	E
Eslek	E
Esmer	K
Esvet	E
Ese	K
Esim	K
Esin	K
Esit	E
Eskin	E
Esmen	U
Esref	E
Ethem	E
Eti	E
Etik	K
Etike	K
Evgin	E
Evin	K
Evirgen	E
Evnur	K
Evren	U
Evrensel	E
Evrim	U
Evrimer	E
Evsen	E
Evsen	E
Eylem	E
Eylül	U
Eymen	E
Eyüp	E
Ezel	U
Ezelî	K
Ezgi	K
Ezgin	K
Ezgü	E
Ezgüer	E
Ezgütekin	E
Fâkihe	K
Fehim	E
Fehime	K
Fehmi	E
Fehmiye	K
Felât	E
Felek	U
Fenni	E
Fenniye	K
Fer	E
Fergün	K
Ferhun	E
Feri	K
Ferih	E
Feriser	K
Feriste	K
Ferit	E
Feriz	E
Fernur	K
Ferruh	E
Fersoy	E
Feruze	K
Ferve	K
Fesih	E
Fethi	E
Fethiye	K
Fetih	E
Fevzi	E
Fevziye	K
Feyiz	E
Feyzettin	E
Feyzi	E
Feyziye	K
Figen	K
Fikret	U
Fikrettin	E
Fikriye	K
Filizer	E
Firuze	K
Fügen	K
Fütüvvet	E
Gelener	E
Gelengül	K
Gelin	K
Gelinkiz	K
Genez	E
Gevher	K
Gevheri	E
Gezer	K
Gezgin	E
Gezginer	E
Girginer	E
Gizem	K
Gizer	E
Gizmen	E
Gögem	U
Gögen	E
Gökel	E
Göken	E
Göker	E
Gökmen	E
Gökmener	E
Gökmete	E
Göknel	E
Gökperi	K
Göksel	U
Gökselen	K
Göksen	U
Göksenin	E
Gökser	E
Göksev	U
Gökseven	E
Göksever	E
Göksen	U
Gökten	E
Göktöre	E
Gölge	K
Gönen	E
Gönener	E
Görez	K
Görkel	E
Görkem	U
Görkemli	U
Görker	E
Görkey	E
Görkmen	E
Görksev	E
Görsev	K
Gövem	K
Gövez	E
Göymen	E
Göze	K
Gözegir	E
Gözem	U
Gözlem	K
Güfte	K
Güher	K
Gülâfet	K
Gülâver	K
Gülegen	E
Gülek	E
Gülel	E
Gülen	K
Gülener	E
Gülengül	K
Gülennur	K
Güler	K
Güleren	K
Gülergin	U
Gülergün	U
Gülersin	K
Güleryüz	E
Gülesen	K
Güleser	K
Gülesin	K
Gülev	K
Gülfem	K
Gülfer	K
Gülgen	K
Gülgez	K
Gülgûne	K
Gülgüney	K
Gülgüzel	K
Gülipek	K
Gülmen	E
Gülnese	K
Gülören	K
Gülözer	K
Gülperi	K
Gülrenk	K
Gülsel	K
Gülseli	K
Gülselin	K
Gülsemin	K
Gülsen	K
Gülser	K
Gülseren	K
Gülserim	K
Gülsev	K
Gülseven	K
Gülsever	K
Gülsevi	K
Gülsevil	K
Gülsevin	K
Gülsezer	K
Gülsezin	K
Gülsinem	K
Gülsüme	K
Gülsehri	K
Gülseker	K
Gülsen	K
Gülseref	K
Gülserif	K
Gültekin	E
Gülten	K
Gülter	K
Gülümser	K
Gülümsen	K
Gülver	K
Gülveren	K
Gülzemin	K
Gümüstekin	E
Günel	U
Güner	U
Güneren	E
Günergin	E
Güneri	E
Günerim	K
Günes	U
Günesen	E
Güney	U
Günfer	K
Güngören	U
Güngöze	E
Günsel	U
Günseli	K
Günsenin	K
Günser	U
Günseren	K
Günsen	U
Güntekin	E
Günten	K
Güntöre	E
Günver	U
Günyeli	E
Gürel	K
Gürer	E
Gürsel	U
Gürselin	K
Gürsen	K
Gürses	K
Gürsev	K
Gürsevil	K
Gürsen	K
Gürten	K
Güven	U
Güze	K
Güzel	K
Güzey	K
Hâkime	K
Hâlet	U
Hekim	E
Heper	E
Hepgül	K
Hepsen	K
Hepyener	E
Hepyüksel	E
Heves	K
Hifziye	K
Hizlier	E
Hikmet	U
Hikmettin	E
Hilmiye	K
Himmet	E
Hossel	K
Hossen	K
Hosses	K
Hosten	K
Hulkiye	K
Hurisel	K
Huriser	K
Huriye	K
Hurrem	K
Hükmiye	K
Hüner	E
Hürmet	U
Hürrem	K
Hürriyet	U
Hürsel	U
Hürsen	K
Hürsev	E
Hürsen	K
Hüseyin	E
Hüsmen	E
Hüsne	K
Hüsniye	K
Hüsnügüzel	K
Hüsnüye	K
Hüsrev	E
Isiker	E
Isiner	E
Iffet	U
Ilergin	E
Ileri	E
Ilerigün	E
Ilke	U
Ilker	E
Ilksel	K
Ilksen	K
Ilksev	K
Ilksen	K
Ilmen	E
Ilmiye	K
Ilsev	E
Ilseven	E
Ilsever	E
Ilsen	K
Iltekin	E
Iltemir	E
Iltemiz	E
Iltemür	E
Ilter	U
Ilteris	E
Iltüze	E
Ime	K
Imer	U
Imge	K
Imre	E
Imren	U
Ipek	K
Ipekel	K
Ipekten	K
Irem	K
Iren	E
Irtek	E
Isen	K
Isenkutlug	K
Ismet	U
Ismen	E
Isseven	E
Issever	E
Isvekâr	K
Ivegen	E
Iyem	U
Iyimser	U
Iyiyürek	E
Izel	K
Izem	U
Izzet	E
Izzettin	E
Kâmile	K
Kâsife	K
Kâzime	K
Kekik	K
Keklik	K
Kelâmi	E
Keles	E
Kelestimur	E
Kemter	E
Kent	E
Kenter	E
Kepez	E
Kerem	E
Kerim	E
Kerime	K
Kermen	E
Kesek	E
Kesim	E
Keskin	E
Keskinel	E
Keskiner	E
Kesfi	E
Kesfiye	K
Kete	E
Keven	E
Kevkep	U
Kevnî	E
Kevser	K
Key	E
Keyfi	E
Kezer	E
Kinel	E
Kiner	E
Kirteke	E
Kirtekin	E
Kismet	U
Kiymet	K
Kiper	E
Kirmen	E
Korel	E
Korer	E
Koryürek	E
Kosuktekin	E
Kökel	E
Köken	E
Köker	E
Köklem	E
Kökten	E
Kömen	E
Körnes	E
Körpe	K
Köse	E
Kösem	K
Kösemen	U
Kösten	E
Kösek	E
Kösker	E
Köymen	E
Közer	E
Kumriye	K
Kutsel	K
Kutseli	K
Kuzey	E
Lâle	K
Lâlegül	K
Lâleruh	K
Lâmiye	K
Lâtife	K
Lemi	E
Lemiye	K
Lerze	K
Lerzis	K
Levent	E
Levin	E
Leylâ	K
Leylâgül	K
Leyli	K
Leylifer	K
Leylüfer	K
Leziz	K
Lezize	K
Lütfiye	K
Mefkûre	K
Meftun	E
Meftune	K
Mehip	E
Mehir	K
Mehmet	E
Mehru	K
Mehti	E
Mehtiye	K
Mehves	K
Mekin	E
Mekki	E
Melek	K
Meleknur	K
Melekper	K
Melekru	K
Melen	E
Melih	E
Melik	E
Melike	K
Melis	K
Meliz	K
Meltem	K
Melûl	U
Memik	E
Memis	E
Memnun	E
Memnune	K
Memo	E
Memun	E
Menekse	K
Menevse	K
Mengi	E
Mengli	K
Mengûs	K
Mengü	U
Mengüer	E
Mengütekin	E
Mensup	E
Mensur	E
Mensure	K
Mensur	E
Mensure	K
Menzur	E
Menzure	K
Mergen	E
Mergup	E
Merih	U
Mersin	E
Mert	E
Mertel	E
Merter	E
Mertkol	E
Mertol	E
Merttürk	E
Merve	K
Meryem	K
Merziye	K
Merzuk	E
Meserret	K
Mesih	E
Mesrur	E
Mesrure	K
Mestur	E
Mesture	K
Mesure	K
Mesut	U
Meshur	E
Meskûr	E
Meskûre	K
Mesru	E
Mete	E
Methiye	K
Metin	E
Metine	K
Metiner	E
Mevlit	E
Mevlût	E
Mevlüt	E
Mevsim	K
Mevzun	E
Mevzune	K
Meyil	K
Meymun	E
Meymune	K
Mezit	E
Meziyet	K
Mezun	E
Mihine	K
Mihriye	K
Mine	K
Minnet	K
Mirkelâm	E
Muhlise	K
Muhsine	K
Muhterem	U
Muhtesem	U
Muine	K
Mukime	K
Munise	K
Muslihe	K
Mutluer	E
Mutlutekin	E
Mutver	E
Müesser	U
Müeyyet	U
Müferrih	U
Müge	K
Mükerrem	U
Mükevven	K
Mükremin	E
Mükrime	K
Mülhime	K
Mülket	E
Mümine	K
Münevver	K
Münife	K
Münime	K
Münire	K
Müren	U
Mürsel	E
Mürüvvet	K
Müsevver	K
Müslime	K
Müslüme	K
Müstenir	E
Müstenire	K
Müserref	U
Müsküle	K
Müstehir	E
Müyesser	K
Müzehher	K
Müzekker	E
Müzeyyen	K
Nefer	E
Nefi	E
Nefis	U
Nefise	K
Nehip	E
Nehir	K
Nehire	K
Nehri	E
Nejlâ	K
Nemutlu	U
Neptün	K
Nergis	K
Nergise	K
Nerim	E
Nermi	E
Nermin	K
Nesil	E
Nesim	E
Nesime	K
Nesimi	E
Nesip	E
Nesli	K
Nesligül	K
Nesrin	K
Nesteren	K
Nese	K
Nesegül	K
Nesem	K
Nesenur	K
Neset	E
Nesever	K
Nesit	E
Nesve	K
Neveser	K
Nevfel	E
Nevgül	K
Nevhiz	K
Nevin	K
Nevinur	K
Nevir	K
Nevit	E
Nevres	U
Nevreste	K
Nevrettin	E
Nevri	E
Nevriye	K
Nevruz	U
Neyire	K
Neyyire	K
Neyyiri	E
Neyzen	E
Nezih	E
Nezihe	K
Nezihi	E
Nezir	E
Nezire	K
Nilüfer	K
Nimet	U
Niyet	K
Nurâlem	K
Nurel	U
Nurer	E
Nurersin	E
Nurettin	E
Nurfer	K
Nuriye	K
Nurmelek	K
Nurper	K
Nurperi	K
Nursel	U
Nurselen	K
Nurseli	K
Nursen	K
Nursenin	K
Nurser	K
Nurseren	K
Nursev	K
Nurseven	K
Nursevil	K
Nursevim	K
Nursevin	K
Nursine	K
Nursen	K
Nurtek	K
Nurtekin	E
Nurten	K
Nurver	U
Nurveren	K
Nurzen	K
Nurzer	K
Nusret	U
Nusrettin	E
Nükhet	K
Nüzhet	U
Ogultekin	E
Oguzer	E
Oker	E
Okergin	E
Oksev	E
Okseven	E
Oksever	E
Oktüre	E
Oktüremis	E
Okver	E
Olguner	E
Onel	E
Oner	E
Onerim	E
Onguner	E
Ongüner	E
Ongünes	E
Onuker	E
Onuktekin	E
Onursev	E
Onurseven	E
Öge	U
Öger	E
Öget	U
Ögetürk	E
Öge	E
Öget	E
Ögmen	E
Öke	U
Ökeer	E
Ökelik	E
Öker	E
Ökkes	E
Ökmen	E
Ökmener	E
Ökte	E
Öktem	E
Öktemer	E
Ökten	E
Öktener	E
Ölen	E
Ölmez	U
Ömer	E
Önel	E
Önemli	E
Önen	E
Öner	U
Öneri	E
Önes	E
Öney	U
Öngel	E
Öngen	E
Öngören	E
Önsel	E
Ören	U
Örenel	E
Örengül	K
Örfiye	K
Örge	K
Örgen	E
Örnek	U
Örsel	E
Örüner	E
Öryürek	E
Ösme	K
Ötlegen	K
Ötüken	E
Övet	E
Öymen	E
Özek	E
Özel	U
Özen	U
Özengin	E
Özengül	K
Özenir	K
Özenli	K
Özer	U
Özerek	E
Özerk	E
Özerkin	E
Özerkmen	E
Özerol	E
Özertem	E
Özge	U
Özgeer	E
Özgen	U
Özgener	E
Özger	E
Özgünel	K
Özgüner	E
Özgünes	U
Özgüney	K
Özgürel	E
Özgüven	E
Özilter	E
Özipek	K
Özke	E
Özkent	E
Özker	E
Özlek	E
Özlem	K
Özlen	U
Özlenen	K
Özler	U
Özleyis	K
Özlüer	E
Özmen	U
Özmert	E
Özöge	E
Özpeker	E
Özpetek	U
Özsel	U
Özselen	U
Özsevi	U
Özsüer	E
Özsen	E
Öztek	E
Öztekin	E
Özten	K
Öztinel	E
Öztiner	E
Özüpek	E
Özver	E
Özveren	E
Özveri	U
Özvermis	E
Pek	K
Peköz	K
Peksu	K
Peksen	K
Pelin	K
Pelit	K
Peren	K
Peri	K
Perinur	K
Periru	K
Perives	K
Perize	K
Permun	K
Pertev	E
Peruze	K
Perver	K
Pervin	K
Perviz	K
Pesen	K
Pesent	K
Petek	K
Peyker	K
Piruze	K
Prenses	K
Püren	K
Pürfer	K
Pürsen	K
Refet	U
Refettin	E
Refi	E
Refig	E
Refih	E
Refihe	K
Refii	E
Refik	E
Refiye	K
Reis	E
Rekin	E
Rekine	K
Remzi	E
Remziye	K
Rengin	K
Reset	E
Resmî	E
Resmigül	K
Resmiye	K
Resul	E
Resik	E
Resit	E
Revis	U
Rezin	U
Rifkiye	K
Ruhisen	K
Ruhiye	K
Ruhsen	K
Ruhsen	K
Rukiye	K
Rusen	U
Ruziye	K
Rüknettin	E
Rüstem	E
Rüstiye	K
Sefer	U
Seferî	E
Segmen	E
Seher	K
Sehergül	K
Sehi	E
Sekine	K
Sel	K
Selâh	E
Selâhi	E
Selâm	E
Selâmet	U
Selâmettin	E
Selâmi	E
Selâtin	E
Selek	E
Selekmen	E
Selen	U
Seler	E
Selisik	U
Selisil	K
Selisin	K
Selim	E
Selime	K
Selin	K
Selmi	E
Selmin	K
Selnur	K
Selok	E
Selvet	K
Selvi	U
Semen	K
Semih	E
Semin	K
Semine	K
Semir	E
Semire	K
Semiye	K
Semuh	E
Senem	K
Sener	E
Senger	E
Sengül	K
Sengün	K
Senî	E
Senih	E
Seniye	K
Sennur	K
Senol	E
Seren	U
Serener	E
Serengül	K
Sergen	E
Sergin	E
Sergül	K
Sergün	K
Serhenk	E
Serhun	E
Serim	E
Serimer	E
Serin	U
Seringül	K
Serkut	E
Sermelek	K
Sermet	U
Sermin	K
Sernur	K
Serol	E
Serpil	K
Serpin	K
Sertel	E
Serter	E
Sertug	E
Server	E
Servet	U
Servi	U
Seven	U
Sevener	E
Sevengül	K
Sevengün	K
Sever	U
Sevgen	U
Sevgi	K
Sevgili	K
Sevgim	K
Sevginur	K
Sevgisun	K
Sevgül	K
Sevgün	E
Sevgür	U
Sevi	K
Sevig	E
Sevik	E
Sevil	K
Sevilen	K
Sevilsen	K
Sevim	K
Sevimgül	K
Sevin	U
Sevnur	K
Sevsen	K
Sevsevil	K
Sevük	E
Sevüktekin	E
Seyfettin	E
Seyfi	E
Seyfiye	K
Seyhun	E
Seyit	E
Seylân	U
Seylâp	K
Seymen	E
Sezek	U
Sezel	K
Sezen	U
Sezer	U
Sezgen	U
Sezgi	U
Sezgin	U
Sezi	E
Sezim	E
Sezin	U
Sezis	E
Sezmen	E
Sirriye	K
Sitkiye	K
Simge	K
Simten	K
Simüzer	K
Sine	K
Sinem	K
Siper	E
Siren	K
Sirer	E
Siret	U
Sirmen	E
Siyret	E
Somel	E
Somer	E
Sonel	K
Soner	E
Sonsen	K
Sonten	K
Sonver	K
Soyer	E
Soygüven	E
Soyluer	E
Soytekin	E
Soyuer	E
Sökmen	E
Sökmener	E
Sökmensü	E
Sökmensüer	E
Sönmez	U
Sönmezer	E
Sözen	U
Sözer	E
Sözmen	E
Suheyp	E
Sulhiye	K
Sumer	U
Sunel	E
Suner	E
Sungurtekin	E
Suphiye	K
Süel	E
Süer	E
Süeren	E
Süergin	E
Süheyl	E
Süheylâ	K
Sülemis	E
Sümer	U
Sümeyre	K
Sünter	E
Sürmeli	K
Süsen	K
Süyek	E
Süzen	E
Sefik	E
Seh	E
Sehâlem	E
Sehim	E
Sehime	K
Sehlevent	E
Sehmuz	E
Sehper	K
Sehriyâr	K
Sehriye	K
Seker	K
Sekime	K
Sekip	E
Sekûr	E
Sekûre	K
Selâle	K
Semi	E
Semim	E
Semime	K
Seminur	K
Sems	E
Semsettin	E
Semsi	E
Semsifer	K
Semsiye	K
Sen	U
Senel	E
Sener	E
Sengil	U
Sengönül	K
Sengül	U
Sengün	U
Seniz	U
Senlen	E
Senlik	E
Sennur	K
Senol	U
Senöz	K
Sensen	E
Sensoy	E
Sensu	K
Sentürk	E
Senyer	K
Senyil	K
Senyurt	E
Senyüz	K
Seref	U
Serefnur	K
Seremet	K
Seren	E
Serif	E
Serife	K
Sermin	K
Sesen	E
Sevket	E
Sevki	E
Sevkinur	K
Sevkiye	K
Simsek	E
Simseker	E
Sive	K
Sivekâr	K
Söhret	K
Sölen	U
Sule	K
Sükrettin	E
Sükriye	K
Sükûfe	K
Tegin	E
Tek	E
Teke	E
Teker	E
Tekes	E
Tekgül	K
Tekil	E
Tekin	E
Tekinel	E
Tekiner	E
Tekinsoy	E
Tekir	E
Tekis	E
Tekiz	E
Tekmil	E
Tekmile	K
Teknur	K
Tekok	E
Tekol	E
Teköktem	E
Teköz	E
Teközer	E
Teksen	U
Teksoy	E
Tekün	E
Tekünlü	E
Telek	U
Telim	E
Telimer	E
Telli	U
Telmize	K
Telvin	K
Temel	E
Temelli	E
Temenni	K
Temime	K
Temir	E
Temirkut	E
Temiz	U
Temizel	E
Temizer	E
Temizol	E
Temizöz	E
Temizsoy	E
Temre	K
Temren	E
Temürlenk	E
Tengir	E
Tengiz	E
Tenigül	K
Tennur	K
Tennure	K
Tenvir	E
Tepegöz	E
Tepel	E
Tepir	E
Terek	E
Terem	E
Terim	U
Terken	K
Tesrif	E
Tesrife	K
Tetik	E
Tetiker	E
Tevekkül	E
Tevfik	E
Tevhit	E
Tevil	E
Tevir	E
Tevs	E
Tevsen	E
Teymur	E
Tez	E
Tezel	U
Tezelli	E
Tezer	U
Tezeren	E
Tezerol	E
Tezgül	K
Tezok	E
Tezol	E
Tezveren	E
Tijen	K
Timurlenk	E
Tiner	E
Titizer	E
Tokel	E
Toker	E
Tokuzer	E
Tokyürek	E
Topel	E
Toper	E
Torel	E
Tökel	E
Tölek	E
Tömek	E
Töre	U
Töregün	E
Törel	E
Töreli	E
Tören	E
Tugrultekin	E
Tugsel	E
Tugser	E
Tugtekin	E
Tuhfe	U
Tutel	E
Tuter	E
Tuzer	E
Tükel	E
Tülek	E
Tülen	K
Tümel	E
Tümen	E
Tümer	E
Tümerk	E
Tümerkin	E
Tüner	E
Tüney	E
Türe	E
Türek	E
Türel	E
Türeli	E
Türemen	E
Türev	E
Türker	U
Türkine	K
Türkiye	K
Türkmen	U
Türksel	U
Türksen	E
Tüze	U
Tüzeer	E
Tüzel	U
Tüzemen	E
Tüzenur	K
Tüzmen	E
Tüzüner	U
Ugurel	E
Ugursel	U
Ugurser	K
Uhuvvet	E
Uluer	E
Ulufer	K
Ulutekin	E
Ulviye	K
Umnise	K
User	E
Usluer	E
Uygunel	E
Uyguner	E
Uzel	E
Uzer	E
Uzgören	E
Uzmen	E
Uztekin	E
Üge	U
Üke	E
Üles	E
Ülez	E
Ülfer	E
Ülfet	U
Ülgen	U
Ülgener	E
Ülger	U
Ülke	K
Ülkem	K
Ülken	E
Ülkenur	K
Ülker	U
Ülkümen	E
Ülküsel	E
Ülküye	K
Ülmen	E
Ümek	E
Ümmet	E
Ümmiye	K
Ümniye	K
Ünek	E
Üner	E
Üngören	E
Ünlem	E
Ünlen	E
Ünlüer	E
Ünsel	K
Ünsev	U
Ünseven	U
Ünsever	U
Ünsevin	E
Ünsiye	K
Ünver	U
Ünveren	E
Ünvermis	E
Ünzile	K
Ürek	E
Ürem	E
Üren	E
Üresin	E
Ürkmez	E
Ürmegül	K
Ürpek	K
Ürper	K
Üsgen	E
Üstek	E
Üstel	E
Üster	E
Üstüner	E
Ütügen	E
Üveys	E
Üye	E
Üzek	E
Üzer	E
Üzeyir	E
Vefi	E
Vefik	E
Vefki	E
Vehip	E
Vekil	E
Velet	E
Veli	E
Velit	E
Veliye	K
Venüs	K
Vergi	E
Vergili	E
Vergin	E
Verim	E
Vesik	E
Vesim	E
Veyis	E
Veysel	E
Veysi	E
Yâren	E
Yegâh	K
Yegân	E
Yegâne	K
Yegin	E
Yeginer	E
Yegrek	E
Yel	E
Yelen	E
Yeler	E
Yelesen	E
Yeleser	E
Yeliz	K
Yeltekin	E
Yemen	E
Yenel	E
Yenen	E
Yener	U
Yenerol	E
Yengi	E
Yenigül	K
Yenin	E
Yenisu	E
Yenisü	E
Yepelek	K
Yerel	E
Yergin	E
Yerik	E
Yersel	E
Yesügey	E
Yesil	U
Yesim	K
Yesne	U
Yeten	E
Yetener	E
Yeter	U
Yeterkiz	K
Yetik	E
Yetim	E
Yetis	E
Yetisen	E
Yetkin	U
Yetkiner	E
Yilsen	K
Yigitel	E
Yigiter	E
Yipek	K
Yöner	E
Yönet	E
Yönetken	E
Yönetmen	E
Yöntem	E
Yurter	E
Yurtgüven	E
Yurtsev	U
Yurtseven	U
Yurtsever	U
Yurtsevil	K
Yurtsevin	K
Yüksel	U
Yükselen	K
Yümniye	K
Yürekli	E
Yürüker	E
Zekâi	E
Zekâvet	K
Zeki	E
Zekire	K
Zekiye	K
Zemin	E
Zemzem	K
Zengin	E
Zennur	K
Zeren	U
Zergûn	K
Zerin	E
Zerrin	K
Zerrinkâr	K
Zerriste	K
Zeynel	E
Zeynep	K
Zeyni	E
Zeyniye	K
Zeyno	K
Zeynur	E
Zeyrek	E
Zihniye	K
Zinet	K
Zinnure	K
Ziver	U
Ziynet	K
Ziyneti	K
Züheyr	E
Zühre	K
Zühtiye	K
Zülfiye	K
Zülfüye	K
Zürriyet	E
Fikir	K
Fikri	E
Filiz	K
Firuz	E
Ful	K
Fuzuli	E
Füsun	K
Füsunkâr	K
Hifzi	E
Kâsif	E
Lâtif	E
Lütfi	E
Lütuf	K
Lütufkâr	K
Müfit	E
Müftü	E
Münif	E
Müsfik	E
Örfi	E
Rifki	E
Tifligül	K
Ufuk	U
Vâkif	E
Yusuf	E
Zülfi	E
Zülfü	E
Zülkif	E
Zülküf	E
Girgin	E
Giz	E
Gögüs	E
Gök	K
Gökgöl	E
Gökhun	E
Göknil	K
Göknur	U
Göksoy	E
Göksu	U
Göksun	U
Göksin	U
Göktug	E
Göktürk	E
Gönül	K
Görgü	E
Görgün	E
Görk	E
Görklü	U
Göyük	E
Gözütok	E
Gül	K
Gülân	K
Gülgönül	K
Gülgûn	K
Gülgün	K
Gülhiz	K
Gülhuri	K
Güliz	K
Gülkiz	K
Güllü	K
Gülmüs	K
Gülnur	K
Gülnus	K
Gülöz	K
Gülriz	K
Gülru	K
Gülruh	K
Gülsim	K
Gülsimin	K
Gülsoy	U
Gülsu	K
Gülsüm	K
Gülsün	K
Gültop	K
Gülüm	K
Gülüstü	K
Gülüs	K
Gülyüz	K
Gümüs	U
Gümüskurt	E
Gümüskut	E
Gün	U
Güngör	U
Güngörmüs	E
Güngül	K
Günisik	E
Güniz	U
Günizi	E
Günizli	E
Günkurt	E
Günkut	U
Günkutlu	E
Günmutlu	E
Günnur	U
Günol	E
Günsili	K
Günsu	K
Güntimur	E
Güntülü	U
Güntürk	E
Güntürkün	E
Günyil	E
Günyol	E
Günyüz	E
Gür	E
Gürgân	E
Gürsu	U
Güz	K
Güzin	K
Güzingül	K
Hosgör	E
Hosnigâr	K
Hülâgü	E
Hürgül	K
Hüsnügül	K
Ilgi	E
Ilgim	U
Ilgin	U
Irisgül	K
Ilgi	U
Ilgin	U
Ilgü	U
Ilgül	K
Ilgün	U
Ilig	E
Ilkgül	K
Irgün	K
Ismigül	K
Iyigün	E
Izgi	U
Izgü	E
Izgül	K
Izgün	K
Kirgiz	E
Kizgin	E
Kizginok	E
Kizginyigit	E
Kongur	E
Korgün	E
Koygun	E
Kutgün	K
Lâlgûn	K
Morgül	K
Mutlugün	E
Müjgân	K
Nigâr	K
Nilgûn	K
Nilgün	K
Nurgök	K
Nurgül	K
Nurgün	K
Nurnigâr	K
Ogus	U
Ogül	K
Ogün	E
Olgun	U
Olgunsoy	E
Olgunsu	E
Ongu	K
Ongun	E
Ongunsu	E
Ongur	E
Ongün	E
Orgun	E
Orgül	K
Orgün	E
Öngör	E
Öngü	E
Öngül	U
Öngün	E
Öngüt	E
Övgü	U
Övgül	K
Övgün	K
Özgü	U
Özgül	K
Özgülüm	K
Özgün	U
Özgür	U
Özsungur	E
Ruhugül	K
Rüzgâr	U
Silgin	E
Singin	E
Singin	E
Songun	E
Songur	E
Songül	K
Sorgun	E
Soyugür	E
Sungu	U
Sungun	E
Sungur	E
Süngür	E
Tokgöz	E
Tongur	E
Toygun	E
Turgut	E
Tuygun	E
Tüngür	K
Türgün	E
Uguz	E
Urgun	E
Urungu	E
Uygu	E
Uygun	E
Uygur	U
Ügü	E
Ülgü	E
Ülgür	K
Üngörmüs	E
Üngün	E
Üngür	E
Ünügür	E
Ürgün	E
Üstüngü	E
Vurgun	E
Yilgül	K
Yilgün	K
Kiziltug	E
Koryigit	E
Köroglu	E
Kugu	K
Mutlug	E
Ogul	E
Ogultürk	E
Ogur	E
Ogus	E
Oguz	E
Oguztüzün	E
Oktug	E
Onug	E
Ögün	U
Ögür	E
Ögüs	U
Ögüt	U
Özogul	E
Özoguz	E
Sigin	E
Sögüt	E
Tigin	E
Togus	E
Toktug	E
Tokuztug	E
Toluntigin	E
Tug	E
Tugkun	E
Tuglu	E
Tugluk	E
Tugrul	E
Tuyug	E
Türkoglu	E
Ugur	U
Ugurlu	U
Ugurol	E
Ugursoy	U
Ugus	U
Ugut	E
Uguz	E
Ulug	E
Yigit	E
Yogun	E
Yulug	E
Yügrük	E
Hâlinur	K
Hizir	E
Hizli	E
Hilâl	K
Hilâlî	U
Hilmi	E
Hosnur	K
Hosnut	K
Hossun	K
Hulki	E
Hulûsi	E
Huri	K
Hursit	E
Huzur	U
Hünkâr	E
Hür	E
Hürmüz	K
Hürol	E
Hüsnü	E
Hüsnühâl	K
Hüsün	K
Ihlâs	E
Lâhik	E
Lâhut	E
Lâmih	E
Mihin	E
Mihri	U
Mihrinur	K
Mirrih	K
Muhip	E
Muhittin	E
Muhlis	E
Muhsin	E
Muhyi	E
Muslih	E
Mühip	E
Mülhim	E
Nuh	E
Nurhilâl	K
Orhun	E
Ruhi	E
Ruhinur	K
Ruhittin	E
Ruhunur	K
Rüsuhi	E
Sulhi	E
Suphi	E
Zihni	E
Zuhur	E
Zuhuri	E
Zühtü	E
Âsik	E
Iris	K
Iriz	E
Irkil	E
Ismik	E
Isik	U
Isikli	E
Isil	K
Isilti	U
Isim	K
Isin	U
Isinsu	U
Isit	K
Iskin	E
Itir	K
Itri	E
Ilkisik	K
Inkilâp	U
Kâzim	E
Kimiz	E
Kin	E
Kinik	E
Kinis	E
Kizik	E
Kizil	E
Kizilkurt	E
Lâyik	E
Misir	K
Mülâzim	E
Nurisik	K
Özkin	E
Piril	K
Pirilti	K
Sâti	E
Sirri	E
Sitki	E
Siyli	E
Siylikiz	K
Sinik	E
Tin	E
Uri	E
Âtik	K
Âzim	E
Ikiz	E
Iklil	K
Iklim	U
Il	E
Ilim	E
Ilki	E
Ilkim	U
Ilkin	U
Ilkiz	U
Ilknur	K
Ilksoy	E
Ilkut	E
Ilkutlu	E
Ilkün	E
Ilsu	U
Iltutmus	E
Iltüzün	E
Inönü	E
Iris	K
Iskit	E
Islâm	E
Islim	K
Islimî	K
Isminur	K
Istiklâl	U
Iskur	E
Iyiol	E
Iyisoy	E
Kâmil	E
Kâni	E
Kâtip	E
Kip	E
Kipkurt	E
Kisi	E
Köksin	E
Köni	E
Lâmi	E
Limon	K
Mikâil	E
Mir	K
Mirnur	K
Misli	K
Muin	E
Mukim	E
Munis	E
Muti	E
Mükrim	E
Mükrimin	E
Mülâyim	E
Mümin	E
Münim	E
Münip	E
Münir	E
Mürit	E
Mürsit	E
Müslim	E
Müsir	E
Nil	K
Nili	K
Nilsu	K
Nuri	E
Nuris	K
Nursim	K
Nusin	K
Nüvit	U
Öniz	U
Örik	E
Özil	U
Özis	K
Öznil	K
Öztimur	E
Öztin	E
Rükni	E
Sili	K
Sim	K
Simin	K
Simruy	K
Sitti	K
Suzi	E
Sükûti	E
Süruri	E
Siir	K
Sirin	K
Timur	E
Timuröz	E
Tin	E
Tinkut	E
Tipi	E
Titiz	U
Toktimur	E
Tomris	K
Tulûi	E
Tuti	K
Tülin	K
Türkili	E
Türkiz	U
Ulvi	E
Ümit	U
Ünsi	E
Yümni	E
Zikir	E
Zikri	E
Zinnur	E
Konuk	E
Konur	E
Konuröz	E
Kopuz	E
Kor	E
Korkut	E
Kosuk	E
Kotuz	E
Koytuk	E
Köksoy	E
Molu	E
Nurol	U
Nurtop	U
Oksu	E
Oktürk	E
Okumus	E
Okur	E
Okus	E
Okuslu	E
Oluk	E
Olus	U
Omur	E
Onuk	E
Onul	E
Onur	U
Onurlu	E
Onursoy	E
Onursu	E
Onursü	E
Orkun	E
Orkus	E
Orkut	E
Ortun	E
Oruk	E
Orum	E
Orun	E
Orus	E
Oruz	E
Otuk	E
Oy	E
Oykut	E
Oylum	K
Oytun	U
Önol	E
Önsoy	E
Özok	E
Özol	E
Özsoy	E
Öztoklu	E
Özütok	E
Som	E
Somnur	K
Sonnur	K
Sonol	K
Sonsuz	U
Sorkun	E
Soykök	E
Soykurt	E
Soykut	E
Soylu	E
Soyöz	E
Sürsoy	E
Tok	E
Toköz	E
Toku	E
Tokus	E
Tokuz	E
Tokyüz	E
Tolon	E
Tolun	E
Topuz	E
Tor	E
Toros	E
Torun	E
Tosun	E
Totuk	E
Toy	E
Tozun	E
Tümkor	E
Türkol	E
Ulusoy	E
Uzsoy	E
Ünlüol	E
Ünlüsoy	E
Ünsoy	E
Üstol	E
Yomut	E
Yosun	U
Zorlu	E
Kök	E
Köklü	E
Köksu	E
Köksür	E
Köktürk	E
Körklü	E
Köz	E
Nuröz	U
Ök	E
Öklü	E
Öktürk	E
Ömür	U
Ömürlü	K
Önnur	K
Önür	E
Örs	E
Örük	E
Örün	U
Ötnü	E
Ötün	E
Övül	U
Övün	U
Öykü	K
Öz	K
Özkök	E
Özkul	E
Özkurt	E
Özkut	U
Özkutlu	E
Özlü	U
Özlütürk	E
Özmut	E
Öznur	U
Özön	E
Özsözlü	E
Özsu	U
Özsun	E
Özsü	E
Özsüt	E
Öztürk	E
Özü	E
Özüm	U
Özün	U
Özyörük	E
Özyurt	U
Sözüsöz	E
Tör	E
Törü	E
Törüm	E
Töz	E
Tözüm	E
Türköz	E
Uluöz	E
Yön	E
Yörük	E
Pullu	K
Pütün	K
Kumru	K
Kurtulus	K
Nur	U
Nurkut	U
Nurlu	K
Nursu	K
Nursun	K
Rüknü	E
Rüstü	E
Sumru	K
Sükrü	E
Tur	E
Tümkurt	E
Türk	E
Türkân	K
Türknur	K
Türkü	K
Tüzüntürk	U
Ulutürk	E
Umur	E
Ur	E
Urluk	E
Uruk	E
Urun	E
Urus	E
Uruz	E
Uztürk	E
Üntürk	E
Ürkün	E
Ürün	U
Yâr	K
Yurt	U
Yurtkulu	E
Yürük	E
Zümrüt	K
Kukus	K
Müslüm	E
Sâmân	E
Su	U
Sukusu	E
Sun	U
Sunu	K
Suut	E
Sü	E
Sükûn	K
Sükût	K
Sülü	E
Sülün	K
Süslü	K
Ulus	E
Ulusu	E
Us	E
Uslu	U
Usuk	E
Usum	E
Usun	K
Üs	E
Üstün	E
Yunus	E
Mustu	E
Tutus	E
Ukus	E
Yumus	E
Kutlu	E
Kutluk	E
Kutun	K
Lut	E
Mut	E
Mutlu	U
Mutluk	E
Tulû	U
Tuluk	E
Tulum	E
Tulun	E
Tun	E
Tutku	E
Tutkun	U
Tutu	E
Tutuk	E
Tutun	E
Tuyuk	E
Tuz	E
Tülün	K
Tümkut	E
Tün	K
Tüzün	U
Ulukut	E
Umut	U
Umutlu	U
Utku	U
Uytun	E
Yunt	E
Uz	E
Üz	E
Zülâl	K
Ulu	E
Ulum	E
Ulun	U
Umu	E
Yumlu	E
Yumuk	K
Yümun	E
Vâlâ	U
Lülü	K
Yülük	E
Ülkü	K
Ülkülü	E
Ülküm	K
Ün	E
Ünlü	U
Abdil	E
Abdilkadir	E
Abdilkerim	E
Abdin	E
Abdis	E
Abdo	E
Abdu	E
Abdul	E
Abdülahat	E
Abdulalim	E
Abdulazim	E
Abdulaziz	E
Abdulbaki	E
Abdulbakir	E
Abdulbari	E
Abdulbekir	E
Abdulcabbar	E
Abdulcebar	E
Abdulcebbar	E
Abdulcelal	E
Abdulcelil	E
Abdulferit	E
Abdulfettah	E
Abdülgadir	E
Abdulgaffar	E
Abdulgafur	E
Abdulgani	E
Abdulgazi	E
Abdulhadi	E
Abdulhafiz	E
Abdulhakim	E
Abdulhalik	E
Abdulhalim	E
Abdulhamid	E
Abdulhamit	E
Abdulhasim	E
Abdulhekim	E
Abdülhizak	E
Abdulkadir	E
Abdülkadirhan	E
Abdulkahir	E
Abdulkani	E
Abdulkerim	E
Abdulla	E
Abdullatif	E
Abdulmecit	E
Abdulmelek	E
Abdulmelik	E
Abdulmenaf	E
Abdulmenav	E
Abdulmennan	E
Abdulmuhsin	E
Abdülmuhtalif	E
Abdülmuhtalip	E
Abdulmutalip	E
Abdulmuttalip	E
Abdülrahim	E
Abdulrahman	E
Abdulrazzak	E
Abdulriza	E
Abdulsabir	E
Abdülsamed	E
Abdülsamet	E
Abdülselam	E
Abdulsemet	E
Abdulvahap	E
Abdulvahit	E
Abdulvasih	E
Abdulvehap	E
Abdurahim	E
Abdurahman	E
Abdurha	E
Abdurrahim	E
Abdurrazak	E
Abdurrazzak	E
Abdurrehim	E
Abdurrezak	E
Abdurrezzak	E
Abdus	E
Abdusamet	E
Abdussamed	E
Abdussamet	E
Abdüsselam	E
Abdylla	K
Abes	E
Abeydullah	E
Abtullah	E
Abubekir	E
Abutalip	E
Abutel	K
Abuzar	E
Abüzeyt	E
Acibe	K
Adder	E
Addule	K
Adelet	K
Adeli	K
Adem	E
Adife	K
Adigüzel	E
Adik	E
Adike	K
Adila	K
Adim	E
Adivye	K
Adiye	K
Adla	K
Adle	K
Adlen	E
Adliye	K
Adul	K
Adulle	K
Afe	K
Afettin	E
Afide	K
Agagül	E
Agah	E
Agakisi	E
Agit	E
Agmur	E
Agnieszka	K
Ahat	E
Ahdettin	E
Ahet	E
Ahizer	K
Ahmed	E
Ahmetali	E
Ahmetcan	E
Ahunur	K
Aile	K
Akar	E
Akgüllü	K
Akimhan	E
Akin	E
Akin	K
Akise	K
Akizer	K
Akkadin	K
Akkiz	K
Aklime	K
Akver	E
Alaaddin	E
Alaadin	E
Alaatdin	E
Alaattin	E
Aladdin	E
Alaeddin	E
Alaetdin	E
Alaettin	E
Alaiddin	E
Alaittin	E
Alatin	E
Alattin	E
Alayittin	E
Aleddin	E
Aleksandra	K
Aleksey	E
Alen	E
Aletdin	E
Alettin	E
Alexandru	E
Aleyna	K
Algin	E
Aliabbas	E
Alibaran	E
Alibey	E
Aliekber	E
Alierk	E
Alifer	E
Aligül	E
Alihsan	E
Aliihsan	E
Alikadir	E
Aliksan	E
Aliman	K
Alimen	K
Alin	E
Aliosman	E
Aliriza	E
Alirza	E
Alis	E
Alisevim	E
Aliseydi	E
Aliya	K
Alize	K
Alkame	E
Alkim	E
Alkim	K
Alkin	E
Allattin	E
Almast	K
Almazbek	E
Almes	K
Almus	E
Alo	E
Alpcan	E
Alperin	K
Alpin	E
Alptunga	E
Altin	K
Altingül	K
Alvi	E
Alye	K
Ambere	K
Amina	K
Amirhamza	K
Ammar	E
Amse	K
Anakadin	K
Anakiz	K
Anayasa	K
Andim	E
Ani	K
Anil	E
Anil	K
Anilcan	E
Anis	K
Anita	K
Anna	K
Ansa	K
Anse	K
Antika	K
Anzel	K
Anzilha	K
Apdil	E
Apdullah	E
Apdurrahman	E
Aptil	E
Aptülkadir	E
Aptullah	E
Arabi	K
Arafa	K
Arap	E
Arapcan	E
Ardil	E
Argon	E
Argun	E
Arifcan	E
Arikan	E
Arin	E
Arinç	E
Ariz	K
Arkin	E
Armahan	K
Arne	K
Arsen	E
Arsevi	K
Arsunar	E
Artemiz	E
Artur	E
Arzi	K
Asamettin	E
Ashan	K
Asif	E
Asife	K
Asik	E
Asim	E
Asiman	K
Asip	E
Asire	K
Asiya	K
Asiyan	K
Asker	E
Askim	K
Askin	E
Askin	K
Askiner	E
Asli	E
Asli	K
Aslican	K
Asligül	K
Aslihan	K
Aslinbey	E
Aslinur	K
Asriye	K
Assiya	K
Assiye	K
Asuhan	K
Asur	E
Atal	E
Atanail	E
Ati	E
Ati	K
Atie	K
Atif	E
Atife	K
Atifet	K
Atika	K
Atike	E
Atike	K
Atil	E
Atilay	E
Atile	E
Atile	K
Atilgan	E
Atilhan	E
Atilim	E
Atilkan	E
Atiyye	K
Atman	E
Atman	K
Atnan	E
Atra	K
Attila	E
Attilla	E
Aura	K
Avna	K
Avsin	E
Avvat	E
Ayan	K
Ayatin	E
Ayatullah	E
Aybaba	E
Aybilge	K
Ayca	K
Ayçan	K
Ayçe	K
Ayçin	K
Aydin	E
Aydin	K
Aydiner	E
Ayise	K
Aykiz	K
Aykutcan	E
Aylar	K
Ayle	K
Aylen	K
Aylil	K
Ayliz	K
Ayne	K
Aynel	K
Aynil	K
Aynilhayat	K
Aynimah	K
Ayno	K
Aynulhayat	K
Aynullah	E
Aynurisa	K
Ayper	K
Aysali	K
Aysana	K
Ayseana	K
Aysekadin	K
Ayseli	K
Aysemin	K
Aysen	K
Aysena	K
Aysene	K
Aysete	K
Aysi	K
Aysil	K
Aysin	K
Aytel	K
Ayter	K
Ayton	E
Aytümen	E
Ayvas	E
Ayzer	K
Ayzin	K
Azad	E
Azaniye	K
Azap	K
Azbiye	K
Azdin	E
Azem	E
Azettin	E
Azima	K
Azimenur	K
Aziza	K
Aznür	K
Azrail	E
Baattin	E
Baba	E
Babek	E
Badel	K
Badem	K
Badet	E
Badiru	E
Bagda	K
Bagdat	K
Bager	K
Bahaddin	E
Bahadir	E
Bahaettin	E
Bahaittin	E
Bahatdin	E
Bahdisen	K
Bahire	K
Bahittin	E
Bahman	E
Bahrettin	E
Bahsi	E
Bahtinur	E
Bahtinur	K
Bahtisen	K
Baise	K
Bakir	E
Bakis	E
Bali	E
Balkir	E
Balkis	K
Balkiyan	K
Balkiz	K
Balli	K
Bani	K
Banihan	E
Banü	K
Banur	K
Barboros	E
Baris	E
Baris	K
Bariscan	E
Barishan	E
Bariye	K
Barsen	E
Bartosz	E
Bartug	E
Basaran	E
Baskin	E
Basra	K
Batdal	E
Batikan	E
Batun	E
Batun	K
Batyr	E
Baver	E
Baydan	K
Bayramali	E
Bayramettin	E
Baysar	E
Baysat	E
Bayse	K
Bayzettin	E
Bediha	K
Bedii	E
Bedirittin	E
Bediriye	K
Bedirnaz	K
Bediya	K
Bedran	E
Bedreddin	E
Bedrivan	K
Begihan	K
Begler	E
Begün	K
Behcet	E
Behican	K
Behide	K
Behime	K
Behiza	K
Behman	E
Behra	K
Behre	E
Behrem	E
Behriye	K
Behsat	E
Behyeddin	E
Bejdar	E
Bekan	E
Bekirhan	E
Beklem	E
Bektasi	E
Belda	K
Belde	K
Belemir	K
Belgizar	K
Belgüzar	K
Belhizar	K
Belkis	K
Belkisa	K
Belkiz	K
Belkizan	K
Belkize	K
Benazil	K
Bendegül	K
Bendihan	K
Benefsi	K
Benhar	E
Benhür	E
Benisan	E
Benna	E
Bennuray	K
Benzegül	K
Beran	E
Berati	E
Beratiye	K
Beray	E
Beray	K
Berda	K
Berfiye	K
Berfo	K
Bergen	K
Bergün	E
Bergün	K
Berhan	E
Berho	E
Berhude	K
Beride	K
Beridiye	K
Beril	K
Berivan	K
Berkcan	E
Berkehan	E
Berkem	E
Berken	K
Berkkalp	E
Berktug	E
Berlin	K
Berre	K
Berru	K
Bersan	E
Bersu	K
Bertal	E
Bervan	K
Berzor	K
Besbin	K
Besbinaz	K
Besdemin	E
Beser	K
Beseriye	K
Besey	K
Besi	K
Besin	E
Beslan	E
Besna	K
Besne	K
Besra	K
Besrai	K
Besravi	K
Besrayi	K
Bessi	K
Bestami	E
Beyazit	E
Beyce	K
Beyhani	E
Beyice	K
Beykut	E
Beyler	E
Beynun	K
Beynur	E
Beysim	E
Beytiye	K
Beytül	K
Beytüllah	E
Beyzanur	K
Bezgin	E
Bhekumusa	E
Bido	K
Bilal	E
Bilcan	E
Bildan	K
Bilgesu	K
Bilgül	K
Bilican	K
Bilihan	K
Bilkay	K
Billur	K
Bilmez	K
Bilnaz	K
Bilor	K
Bilun	K
Binevs	K
Binyami	E
Binyamin	E
Birand	E
Birdane	K
Birdesen	K
Birgul	K
Birgüzel	K
Birkay	E
Birön	E
Birsele	K
Birseren	K
Birsev	K
Birtekin	E
Bisar	E
Bitül	K
Bonci	E
Boracan	E
Böre	K
Bubo	E
Bugse	K
Bugu	K
Buhari	E
Buhide	K
Bukan	E
Bulca	K
Bülend	E
Bulent	E
Bulunmaz	K
Bünyami	E
Bünyamil	E
Bünyamün	E
Burakbey	E
Burakhan	E
Buray	E
Burçay	E
Burçe	K
Burcuhan	K
Bürdem	K
Büreyre	K
Bürhan	E
Burhaneddin	E
Burtay	E
Burtay	K
Buson	K
Busra	K
Büsranur	K
Caferiye	K
Cafet	E
Çagatay	E
Çagda	E
Çagdan	E
Çagdan	K
Çagil	E
Çagil	K
Çagin	E
Çagin	K
Çagri	E
Çagri	K
Çagtay	E
Cahid	E
Cahti	E
Caide	K
Cait	E
Çakir	E
Çakir	K
Çalis	E
Camal	E
Camia	K
Canali	E
Candeniz	E
Candirem	E
Cangir	E
Canseli	K
Çanser	K
Canset	K
Cansin	E
Cansin	K
Cansukan	K
Canur	K
Casim	E
Cavat	E
Cavide	K
Cayide	K
Cazime	K
Cebli	E
Cefahir	K
Cefair	K
Cefer	E
Celal	E
Celaleddin	E
Celaletdin	E
Celalettin	E
Cemale	K
Cemali	E
Cemide	K
Cemiliye	K
Cemine	K
Cemiyle	K
Cemocan	E
Cenay	K
Cenkoglu	E
Cenneti	K
Cerasela	K
Cercis	E
Cerem	K
Ceride	K
Cesarettin	E
Çetine	K
Çetmen	E
Cevale	K
Çevregül	K
Cevrinaz	K
Cevzet	E
Ceydanur	K
Ceykan	E
Ceyla	K
Ceylan	E
Ceylan	K
Ceylani	E
Ceylin	K
Ceynur	K
Cezair	E
Cezair	K
Cezanur	K
Cezminur	K
Cezo	E
Cida	E
Çidem	E
Çidem	K
Ciden	K
Çig	K
Çigse	K
Cihad	E
Cihadi	E
Cihanber	E
Çile	K
Çilem	K
Çilga	K
Çili	K
Çinar	E
Çinar	K
Çise	K
Çisel	K
Çisem	K
Civeyra	K
Çiydem	K
Çollu	E
Cosgun	E
Coskan	E
Çoskun	E
Cüferiye	K
Cuheyna	K
Cülye	K
Cumaali	E
Cuman	E
Cumazel	K
Cumaziye	K
Cüneyd	E
Cüneyit	E
Cunfer	E
Curabey	E
Curiye	K
Dagcan	E
Dagistan	E
Dagittin	E
Dahar	E
Dahil	E
Daimi	E
Damlagül	K
Damlanur	K
Dane	K
Daniyer	E
Darçin	K
Darin	K
Dawid	E
Daylan	E
Deham	E
Delal	K
Delale	K
Delali	K
Delel	K
Delfin	K
Delil	E
Delila	K
Demirali	E
Denis	E
Denizgülü	K
Denizhun	E
Dergi	K
Derkay	E
Derle	K
Deryal	K
Destan	E
Destan	K
Destina	K
Deva	K
Devris	E
Devr˜m	E
Deyer	E
Digdem	K
Dijle	K
Dilan	K
Dilara	K
Dilare	K
Dilaver	E
Dilaver	K
Dilazer	K
Dilcan	K
Dilder	E
Dilfuraz	K
Dilfuruz	K
Dilfuzar	K
Dilihan	K
Dilruba	K
Dilsa	K
Dilsad	K
Dilser	E
Dilvin	K
Dinara	K
Dincer	E
Direncan	E
Direnis	K
Divan	K
Diyaddin	E
Diyar	E
Dizem	K
Di¦Dem	E
Dogaç	E
Dogacan	E
Dogancan	E
Dogcan	K
Doguscan	E
Dolat	K
Dolgun	E
Dona	E
Dönay	K
Döndühan	K
Döner	K
Dönsün	K
Dorukan	E
Dudhan	K
Dudugül	K
Dudusen	K
Duha	K
Duhan	E
Dünya	E
Dünya	K
Dünyale	K
Dünyamin	E
Durali	E
Durana	K
Durangül	K
Durdali	E
Durdane	K
Durdaniye	K
Durdiye	K
Durgadin	K
Durgül	K
Durgut	E
Durhasan	E
Duriye	K
Durkadin	K
Durmusali	E
Durna	K
Durnel	K
Durri	K
Dursade	K
Dursadiye	K
Dursan	E
Dürsef	K
Dürsel	K
Dursen	K
Dursine	K
Dürsiye	K
Dursunali	E
Dursuniye	K
Dürüye	K
Duryan	K
Duyal	E
Duygu	K
Duyguhan	K
Eba	E
Ebazel	E
Ebedin	E
Ebide	K
Ebilfez	E
Ebise	K
Eblike	K
Ebozeyt	E
Ebu	E
Ebuakil	E
Ebülfet	E
Ebutalip	E
Ebuzer	E
Ecem	K
Edanur	K
Edaviye	K
Edaye	K
Edebiye	K
Edep	E
Edeviye	K
Edib	E
Edibiye	K
Edizhun	E
Ednan	E
Efaket	K
Efecan	E
Efil	K
Efkan	E
Eflatun	E
Efrahim	E
Efrail	E
Efraim	E
Eframil	E
Efrayim	E
Efsel	E
Efsunkar	K
Eftal	E
Eftal	K
Egecan	E
Egem	K
Egemen	E
Ehad	K
Ehlem	K
Ehliiman	K
Ela	K
Elame	K
Elamiye	K
Elanur	K
Elay	K
Eldar	E
Eleddin	E
Elem	K
Elfazi	K
Elfide	K
Elfize	K
Elgiz	K
Elham	K
Elide	K
Elifana	K
Elifgizem	K
Elifgül	K
Elifhan	K
Elifnur	K
Elifsena	K
Elis	K
Eliz	K
Ellez	E
Elmar	E
Elmaze	K
Elnara	K
Elnaz	K
Elnur	E
Elvadiye	K
Elvida	K
Elvin	E
Elvin	K
Elyasa	E
Elzem	K
Ema	K
Emal	K
Embiye	K
Emeriç	E
Emeti	K
Emile	K
Emina	K
Emincan	E
Emine.	K
Emineeylem	K
Eminei	K
Eminhan	E
Emini	K
Eminkadin	K
Eminos	K
Emirali	E
Emiray	E
Emiray	K
Emirayse	K
Emircan	E
Emire	K
Emirnaz	K
Emirsan	E
Emis	K
Emise	K
Emra	E
Emra	K
Emrahcan	E
Emral	K
Emrecan	E
Emrehan	E
Emru	E
Emsel	K
Emür	E
Enbiye	K
Encan	E
Enercin	E
Enez	E
Engin.	E
Engül	K
Enser	E
Enüs	E
Enzile	K
Enzüle	K
Erap	E
Eraycan	E
Ercet	E
Erchan	E
Erçin	E
Erda	E
Erdar	E
Erdim	E
Erdinay	E
Erdogan	E
Erdost	E
Erebiye	K
Erencem	E
Erep	K
Ergülü	E
Erife	K
Erince	K
Eriscan	E
Erkam	E
Erkay	E
Erkil	E
Ermin	E
Ernes	E
Ersafak	E
Ersah	E
Ersan	K
Ersi	E
Ertural	E
Erturul	E
Eruze	K
Erva	K
Ervaniye	K
Erzem	K
Esad	E
Esalettin	E
Esame	K
Esef	E
Esefatma	K
Esem	K
Esenay	K
Eset	E
Eshabi	E
Eshat	E
Esiana	K
Esil	K
Esiye	K
Eskan	K
Eslem	K
Esmanperi	K
Esmanur	K
Esme	K
Esmecan	K
Esmegül	K
Esmehan	K
Esmerhan	K
Esmin	K
Esmine	K
Esmiye	K
Espir	E
Esranur	K
Esrin	K
Esse	K
Etem	E
Etkin	E
Eva	K
Evde	K
Evenur	K
Evinç	K
Evlim	K
Evra	K
Evrin	K
Evsun	K
Eyne	K
Eysel	K
Eyüb	E
Eyup	E
Eyüpcan	E
Eyvaz	E
Eyves	E
Eyyüp	E
Eyyüpcan	E
Ezaettin	E
Ezet	K
Ezher	K
Ezime	K
Ezine	K
Eznur	E
Ezo	K
Faakim	E
Faali	K
Faden	K
Fadil	E
Fadima	K
Fadimana	K
Fadimeana	K
Fadimehanim	K
Fadiya	K
Fadiye	K
Fadliye	K
Fagat	K
Fahreddin	E
Fahrittin	E
Fahrullah	E
Faide	K
Faike	K
Faime	K
Faki	E
Fakiri	E
Fakiye	K
Fakriye	K
Fakrullah	E
Fami	E
Famile	K
Fanambinana	E
Faniye	K
Faraç	E
Fariz	E
Fati	K
Fatigül	K
Fatik	K
Fatim	K
Fatima	E
Fatima	K
Fatimana	K
Fatimatüzzehra	K
Fatime	K
Fatimet	K
Fatimetözehra	K
Fatinur	K
Fatis	K
Fatiye	K
Fatmaana	K
Fatmadudu	K
Fatmakadin	K
Fatmana	K
Fatmanim	K
Fatmasu	K
Fatmatül	K
Fatme	K
Fatou	K
Fatuma	K
Fatümatüzzehra	K
Fayik	E
Fayika	K
Fayize	K
Faysel	E
Fazil	E
Fazila	K
Fazile	K
Fazli	E
Fazul	E
Fedakar	E
Fedan	K
Fedayi	E
Feden	K
Fedile	K
Fedim	K
Fedime	K
Fedriye	K
Fefharet	K
Fehiman	K
Fehire	K
Fehmettin	E
Feki	E
Fekrullah	E
Felekferz	K
Feleknaz	K
Feleksan	K
Felemez	E
Fendal	E
Fendiye	K
Fener	K
Fensur	E
Ferahdiba	K
Ferahiye	K
Feramüz	E
Feran	E
Ferat	E
Ferayi	E
Ferayi	K
Ferdag	K
Ferdin	E
Ferdun	E
Feremez	E
Ferfuri	K
Fergal	E
Fergül	K
Ferid	E
Ferihan	E
Ferihan	K
Ferik	E
Ferik	K
Ferime	K
Ferinaz	K
Feris	K
Feristah	K
Feriya	K
Ferizan	K
Ferize	K
Fermin	K
Fermuta	K
Ferrah	K
Ferru	E
Fersat	E
Fersun	K
Ferudun	E
Feruz	E
Feruza	K
Feruzan	K
Ferüze	K
Ferya	K
Feryal	K
Feryas	K
Feryat	E
Ferzende	E
Ferzender	E
Ferzi	E
Ferziye	K
Fetane	K
Fetdah	E
Feti	E
Fetiye	K
Fettullah	E
Fetullah	E
Fevvaz	E
Fevzettin	E
Feyat	E
Feyaz	E
Feyfuri	K
Feyime	K
Feyiznur	K
Feyme	K
Feyruz	E
Feyruz	K
Feyruze	K
Feysal	E
Feysel	E
Feyyat	E
Feyz	E
Feyzanur	K
Feyzin	K
Fezal	K
Fezaye	K
Fezayi	E
Fezile	K
Fidaniye	K
Fidaye	K
Fidel	K
Fidelya	K
Fideyl	E
Fikrat	E
Filay	E
Fildan	K
Filis	K
Filit	E
Fincan	K
Finci	K
Findik	K
Findika	K
Firat	E
Firathan	E
Firdes	K
Firdest	K
Firdevis	K
Firiha	K
Firke	K
Firüzan	K
Firyaset	K
Fisun	K
Fitnet	K
Fuad	E
Fulden	K
Fulten	K
Fülya	K
Fundagül	K
Furat	E
Fürgan	K
Fürkan	E
Fürüzan	K
Fussulet	K
Füsün	K
Gabel	K
Gabil	E
Gabriela	K
Gadiriye	K
Gafure	K
Gahraman	E
Galib	E
Galiya	K
Gamzegül	K
Ganim	E
Garip	E
Gassan	E
Gayet	K
Gazal	K
Gazali	K
Gazap	E
Geji	K
Genime	K
Georgeta	K
Gevi	K
Gevrin	E
Geylani	E
Gilman	K
Ginyas	E
Giryan	K
Gisver	K
Giyasettin	E
Giymet	K
Gizemnur	K
Gizemsu	K
Göçeri	E
Gögercin	K
Göher	K
Gökan	E
Gökbuke	K
Gökçay	K
Gökce	K
Gökçekalp	E
Gökis	K
Göksemin	K
Gölgen	E
Göli	K
Gölkem	E
Goncay	K
Gönlüm	K
Görgen	E
Görkan	E
Govercin	K
Gözdehan	K
Gözdem	K
Gözdenur	K
Gözel	E
Gözel	K
Gözen	K
Grzegorz	E
Gübra	K
Gülabi	E
Gülabiye	K
Güladin	E
Gülafer	K
Gülaga	E
Gülali	E
Gülamiye	K
Gülan	K
Gülaver	K
Gülaydin	K
Gülban	K
Gülbani	K
Gülbarin	K
Gülbeddin	E
Gülbeg	E
Gülberat	K
Gülbettin	E
Gülbeyan	K
Gülbeyde	K
Gülbie	K
Gülbiye	K
Gülcay	K
Gülçe	K
Gülcegün	K
Gülcehal	K
Gülcema	K
Gülcemile	K
Gülçerek	K
Gülceylan	K
Güldali	K
Güldam	K
Güldiz	K
Güldurdu	K
Güle	K
Gülefer	K
Gülem	K
Gülemir	E
Gülendem	K
Gülendiye	K
Gülengün	K
Gülenser	K
Güley	K
Güleycan	K
Güleyda	K
Gülezgi	K
Gülfadim	K
Gülfami	K
Gülfan	K
Gülfari	K
Gülfatma	K
Gülfen	K
Gülferi	K
Gülferide	K
Gülfethiye	K
Gülfikar	K
Gülfire	K
Gülfiye	K
Gülfizar	K
Gülfüzar	K
Gülfüze	K
Gülgiz	K
Gülgül	K
Gülhanim	K
Gülhaniye	K
Gülhat	K
Gülhis	K
Gülhisar	K
Gülhizar	K
Gülhuriye	K
Gülhüzar	K
Güli	E
Güli	K
Gülice	K
Gülihsan	K
Gülin	K
Gülisa	K
Gülisan	K
Gülisraf	K
Gülkadin	K
Gülkiz	K
Güllabiye	K
Gülleman	K
Güller	K
Gülli	K
Gülliya	K
Güllizar	K
Güllünar	K
Güllünaz	K
Güllüzar	K
Gülmehmet	E
Gülmenevse	K
Gülmez	K
Gülmine	K
Gülminnet	K
Gulmirace	K
Gulmustafa	E
Gülnade	K
Gülnam	K
Gülisimler	K
Gülnara	K
Gülnarin	K
Gülnaz	K
Gülnaziye	K
Gülnigar	K
Gülnihan	K
Gülorya	K
Gülözge	K
Gülpasa	K
Gülper	K
Gülpinar	K
Gülrengin	K
Gülsa	K
Gülsabiya	K
Gülsade	K
Gülsaran	K
Gülsat	K
Gülseda	K
Gülseher	K
Gülsehriye	K
Gülsem	K
Gülsen	K
Gülsena	K
Gülsenem	K
Gülsepen	K
Gülseri	K
Gülserin	K
Gülseval	K
Gülsevdi	K
Gülsevim	K
Gülsifa	K
Gülsin	K
Gülsiye	K
Gülsü	K
Gülsultan	K
Gülsum	K
Gülsun	K
Gültülin	K
Gülü	K
Gülüfer	K
Gülümse	K
Gülün	K
Gülünay	K
Gülüs	K
Gülüsan	K
Gülüsen	K
Gülüser	K
Gülüstan	K
Gülüsün	K
Gülüz	K
Gülüzar	K
Gülyar	K
Gülyaz	K
Gülyeter	K
Gülzade	K
Gülzadiye	K
Gülzide	K
Gülziye	K
Gümrah	E
Gümrah	K
Günar	K
Günaydin	E
Güncel	E
Güncel	K
Günday	K
Güngör	E
Güngöre	K
Günnür	K
Günrem	K
Günsiray	K
Güntaç	E
Güralp	E
Gürani	E
Gürçag	E
Gürçay	E
Gürçim	K
Gürcü	K
Gürcüye	K
Gürelcem	E
Gürgan	E
Gürkay	E
Gürler	E
Gürman	E
Gürol	E
Gürsal	E
Gürsat	E
Gürser	K
Gürsoy	E
Gurur	E
Güssüm	K
Güssün	K
Güsüm	K
Güverçin	K
Güyhan	K
Güzella	K
Güzeyde	K
Güzgül	K
Güzüde	K
H.	E
H.	K
Habes	E
Habib	E
Habiba	K
Habibe	K
Habil	E
Habip	E
Habiybe	K
Hacar	K
Hacere	K
Haci	E
Haci	K
Haciali	E
Hacibey	E
Hacice	K
Hacihanim	K
Hacikadin	K
Hacile	K
Hacili	K
Haciosman	E
Hacire	K
Haco	E
Hadi	E
Hadice	K
Hadime	K
Hadis	E
Hadrey	K
Hafife	K
Hafir	E
Hafise	K
Hafit	E
Hafiye	K
Hafiz	E
Hafiza	K
Hafset	K
Hafside	K
Hafza	K
Hajarat	K
Hakife	K
Hakik	K
Hakim	E
Hakime	K
Hakiye	K
Hakki	E
Hakki	K
Haldün	E
Halid	E
Halidiye	K
Halidun	E
Halilibrahim	E
Halilurrahman	E
Halimedudu	K
Halimi	K
Halimser	K
Halisa	K
Haliye	K
Haluk	E
Hal˜l	E
Hamail	K
Hamayil	K
Hamdin	E
Hamdune	K
Hamet	E
Hamid	E
Hamire	K
Hamma	K
Hamsa	K
Hamse	K
Hamsiye	K
Hanasli	K
Handenur	K
Hanen	K
Haney	K
Hangül	K
Hani	K
Hanifi	E
Hanik	K
Hanim	K
Hanime	K
Hanimi	K
Hanimkiz	K
Hanimsah	K
Hanimzer	K
Hanperi	K
Hansa	K
Hanse	K
Hanume	K
Hanze	K
Hanzey	K
Hapa	K
Hapiç	K
Harabi	E
Harbinaz	K
Harip	K
Haris	E
Harise	K
Haritdin	E
Hariye	K
Hariz	E
Hasalettin	E
Hasamittin	E
Hasanali	E
Hasangazi	E
Hasanhilmi	E
Hasbiye	K
Hasem	E
Hasgüllü	K
Hasi	K
Hasib	E
Hasine	K
Hasivet	K
Haskar	K
Haskiz	K
Hasrettin	E
Hassi	K
Hassiye	K
Hata	E
Hatay	K
Hatiçe	K
Hatike	K
Hatimet	K
Hatin	K
Hatira	K
Hatiyce	K
Hattap	E
Havadudu	K
Havagül	K
Havali	K
Havana	K
Havane	K
Havanim	K
Havanur	K
Havar	K
Havelya	K
Havil	K
Havize	K
Havsar	E
Havse	K
Havser	K
Havsun	K
Havvagül	K
Havvana	K
Havvane	K
Havvanur	K
Havvas	E
Hayali	E
Hayas	E
Hayel	K
Hayirli	K
Haymil	E
Hayreddin	E
Hayredin	E
Hayrinisa	K
Hayrinnusa	K
Hayrittin	E
Hayrun	K
Hayrunisa	K
Hayrunnas	E
Hayrunnisa	K
Hazarcan	K
Hazari	K
Hazbiye	K
Hazim	E
Haziret	E
Hazna	K
Hazni	K
Hazrat	E
Hecide	K
Heday	K
Hediyegül	K
Hedla	K
Hedle	K
Hefin	K
Hefit	E
Hekime	K
Hekmet	E
Helen	K
Helim	E
Helime	K
Helin	K
Heman	K
Hemi	K
Hemide	K
Hemrevin	E
Hena	K
Henda	K
Henife	K
Henzede	K
Herdem	K
Herdemcan	K
Hergül	K
Hesibe	K
Hesna	K
Hetike	K
Heva	K
Heval	K
Hevin	K
Hevzi	K
Heybetullah	E
Heyfhilat	K
Heyvetullah	E
Hezal	K
Hezare	K
Hezel	K
Hezniye	K
Hibe	E
Hicazi	E
Hicaziye	K
Hicri	E
Hicrigül	K
Hidaye	K
Hidir	E
Hifzullah	E
Hikmiye	K
Hilal	E
Hilal	K
Hilayda	K
Hilin	K
Hilman	K
Hilvan	K
Hilye	K
Hinar	K
Hindal	E
Hinet	K
Hino	E
Hisar	E
Hisemiddin	E
Hitit	E
Hiva	E
Hivda	K
Hizir	E
Hizlan	E
Hizni	E
Hizniye	K
Hocamurat	E
Hogir	E
Hökkes	E
Homayi	K
Hopan	K
Horasanli	E
Hori	K
Horiye	K
Hörü	K
Hosgün	K
Hosnaz	K
Hozan	E
Hšlya	E
Hübriye	K
Huccet	E
Hüda	K
Hüdai	E
Hüdakar	K
Hüdanur	K
Hüdaye	K
Huldiye	K
Hulisi	E
Hulku	E
Hulusi	E
Hulusu	E
Hülye	K
Huma	K
Humayun	K
Humeyin	K
Humeyra	K
Hünkar	E
Hürdünya	K
Hüreyra	K
Hürgazi	E
Hüri	K
Hurinaz	K
Hüriye	K
Hüriyet	E
Huriyet	K
Hurizad	K
Hürküs	K
Hurma	K
Hürmüs	K
Hurriyet	K
Hürsehit	E
Hursitedip	E
Hürü	K
Hürüle	K
Hürüyet	K
Huryeddin	E
Hüsameddin	E
Hüsametdin	E
Hüsammeddin	E
Hüsem	E
Huseyin	E
Hüseyn	E
Husna	K
Hüsnem	K
Hüsni	E
Hüsni	K
Husnigül	K
Hüsnüce	K
Hüsnüer	E
Hüsref	E
Hüsrem	E
Husret	E
Hussaini	E
Hüssam	E
Huzam	E
Hüzeyca	K
Huzeyfe	E
Hüzni	E
Hüzüme	K
Huzuri	E
Ibadiye	K
Iban	E
Ibrahimethem	E
Ibrahimhalil	E
Ibrahimilker	E
Ibrail	E
Içil	K
Iclal	E
Iclal	K
Idan	E
Ide	K
Idiris	E
Idris	E
Ifagat	K
Ifaget	K
Ifaze	K
Ifdadiye	K
Iftade	K
Iftar	K
Ihram	E
Ihsane	K
Ihtisam	E
Ijla	K
Ijlal	K
Ikbale	K
Ikilem	K
Iklama	K
Iklime	K
Ikrameddin	E
Ikrar	E
Ilavet	K
Ilbegi	E
Ilfar	K
Ilgahan	K
Ilgihan	K
Ilgim	K
Ilgin	E
Ilgin	K
Ilhamettin	E
Ilkat	E
Ilkel	K
Ilkem	E
Ilkem	K
Ilklima	K
Illettin	E
Ilmafer	E
Ilmi	E
Ilmiddin	E
Ilper	K
Ilten	E
Ilyaz	E
Imaddin	E
Imahan	K
Imatullah	K
Imhan	K
Imihan	K
Imirza	E
Immigülsüm	K
Immihan	K
Immühan	K
Imral	K
Imran	E
Imran	K
Imrana	E
Imrel	K
Imrihan	K
Inancan	E
Incifir	K
Incihan	K
Incil	E
Incilay	K
Intihap	E
Intimas	K
Inzile	K
Iran	K
Iremnur	K
Irfide	K
Irzavan	E
Isa.	E
Isak	E
Isik	E
Isik	K
Isil	K
Isilay	E
Isilay	K
Isin	E
Isin	K
Isinsu	K
Iskan	E
Islam	E
Islime	K
Ismahan	K
Ismailhakki	E
Ismehan	K
Ismetullah	E
Ismi	K
Ismihan	K
Isra	K
Issa	E
Istem	K
Istiham	K
Isvendi	E
Isvendiyar	E
Itir	K
Itris	E
Ivyek	K
Iyam	K
Izaura	K
Izetin	E
Izettin	E
Izlem	K
Izlifet	K
Iznihar	K
Izzeddin	E
Izzetin	E
Jacub	E
Jalen	K
Jalile	K
Jan	E
Jankat	E
Jaruthip	K
Jefide	K
Jiyan	K
Joanna	K
Julide	K
Julude	K
Kabile	K
Kablan	E
Kaddafi	E
Kadircan	E
Kadirgin	K
Kadiriye	K
Kadirye	K
Kadisah	K
Kafiye	K
Kafur	E
Kahamurat	E
Kahriman	E
Kakil	E
Kalem	E
Kalo	E
Kamal	E
Kamelya	E
Kameriye	K
Kamil	E
Kamila	K
Kamilcan	E
Kamile	K
Kamiren	E
Kamuran	E
Kamuran	K
Kanaat	K
Kanco	E
Kandef	K
Kania	K
Karafil	K
Karani	E
Kardogan	E
Karer	K
Kargül	K
Karip	E
Karol	E
Kaside	K
Kasif	E
Kasim	E
Kasimhan	E
Kassim	E
Katarzyna	K
Katibe	K
Katife	K
Katip	E
Kaver	K
Kazanfer	E
Kazi	K
Kazim	E
Kazime	K
Kebira	K
Kefaattin	E
Kefser	K
Kehribar	K
Kelami	E
Kelcik	E
Kelem	K
Kemaleddin	E
Kenanbey	E
Kendal	E
Kendi	K
Keremhan	E
Kerima	K
Kerziban	K
Kerzik	K
Keser	K
Kesire	K
Kesra	E
Ketayi	K
Ketibe	K
Kevi	K
Kevni	E
Kezibe	K
Kezziban	K
Kibriya	K
Kibriye	K
Kiliç	E
Kilman	K
Kimet	K
Kinem	K
Kini	K
Kiral	E
Kirez	K
Kismet	E
Kismet	K
Kismis	K
Kitan	K
Kivanç	E
Kivanç	K
Kivilcim	E
Kivilcim	K
Kiyafet	K
Kiyas	E
Kiyasettin	E
Kiyasi	E
Kiymaz	E
Kiymet	K
Kiymetli	K
Koblay	E
Köçer	K
Koka	K
Kömeç	K
Korçay	E
Korkmazalp	E
Korsah	E
Kotas	E
Kral	E
Krzysztof	E
Kuaybe	K
Kübar	K
Kublay	E
Kübran	K
Kübranur	K
Küçük	E
Küçük	K
Kudiret	E
Kuduret	K
Külter	K
Kültigin	E
Kumas	K
Kumray	K
Kumri	K
Kuntay	E
Kuntsav	E
Küpra	K
Küpriye	K
Kural	E
Kurban	E
Kurbani	E
Kürciye	K
Kurultay	E
Küsün	K
Kutbettin	E
Kütezziban	K
Kütfettin	E
Kutlughan	E
Kutluhan	E
Kutret	E
Kutret	K
Kutsi	E
Kuzeyde	K
Kuzidiye	K
Kuzudiye	K
Laden	K
Ladiker	K
Ladin	K
Laika	K
Lale	K
Lalegül	K
Lalever	K
Lalezar	K
Lalifer	K
Lalihan	K
Lami	E
Lamia	K
Lamih	E
Lamiye	K
Latif	E
Latife	K
Latifhan	E
Laze	K
Lazgin	E
Lebude	K
Lemangül	K
Lemye	K
Letife	K
Levend	E
Levize	K
Levziye	K
Leyla	K
Leylan	K
Leylanur	K
Leylufer	K
Leymun	K
Leyzan	K
Lezgin	E
Lezgin	K
Libas	K
Lida	K
Lider	E
Lifar	K
Ligar	K
Lilianna	K
Lilifer	K
Lilüfer	K
Lilve	K
Liman	K
Limun	K
Lina	K
Linda	K
Lisa	K
Lisan	K
Lokman	E
Lüfen	K
Lukasz	E
Lülgün	K
Lülüfer	K
Lutfi	E
Lutfiye	K
Lutfü	E
Lutfullah	E
Lütfüye	K
Lütviye	K
Luup	K
M.	E
M.	K
Maciej	E
Mafak	E
Mafiret	K
Mafiye	K
Mafuzer	K
Magbule	K
Maggül	K
Mahfuza	K
Mahfuze	K
Mahide	K
Mahigül	K
Mahiner	K
Mahiye	K
Mahli	E
Mahmud	E
Mahmudiye	K
Mahnaz	K
Mahpus	E
Mahsubiye	K
Mahsuk	E
Mahsul	E
Mahsum	E
Mahyettin	E
Maigül	K
Makhaddin	E
Maksüde	K
Mamo	E
Mansurali	E
Marcin	E
Marek	E
Mariama	K
Masar	E
Mashar	E
Maside	K
Matan	K
Matem	E
Mateusz	E
Maver	K
Mavus	K
Mayide	K
Mayile	K
Mayir	E
Maynur	K
Mayseker	K
Maysel	K
Mazen	E
Mazes	K
Maziye	K
Mazlüme	K
Mebrule	K
Mebure	K
Mecbure	K
Mecburiye	K
Mecdulin	K
Mecra	K
Mecrum	E
Medhat	E
Media	K
Mediye	K
Mefal	K
Mefaret	K
Mefarettin	E
Mefide	K
Mefkure	E
Mefküre	K
Mehbare	K
Mehbup	K
Mehdiyar	K
Mehemmed	E
Meherrrem	E
Mehlibar	K
Mehman	E
Mehmed	E
Mehmetali	E
Mehmetcan	E
Mehmetemin	E
Mehmethalit	E
Mehmethan	E
Mehmethanifi	E
Mehmetnesim	E
Mehmetsait	E
Mehmetzahir	E
Mehmüre	K
Mehnur	K
Mehri	K
Mehriban	K
Mehrican	K
Mehrigül	K
Mehtun	E
Mekail	E
Mekan	E
Mekbule	K
Mekiya	K
Mekiye	K
Mekkiye	K
Mektup	K
Melaha	K
Melahat	K
Meldanur	K
Meleha	K
Melehat	K
Melekey	K
Meleki	K
Melihan	K
Melihat	K
Melihcan	E
Melihe	K
Melika	K
Melikkan	K
Meliknur	K
Melul	K
Memet	E
Memetali	E
Memetcan	E
Memihan	K
Memili	E
Memnuniye	K
Menci	E
Mendo	E
Mendufa	K
Menduh	E
Menduha	K
Menendi	K
Menfeat	K
Menfiye	K
Menhur	K
Menica	K
Menice	K
Menife	K
Menis	K
Menisan	K
Mensür	K
Mensüre	K
Menzil	K
Merali	E
Meray	K
Merba	K
Merban	K
Merda	K
Merdali	E
Merdane	K
Merdiye	K
Mergüze	K
Merhuze	K
Merim	K
Meriman	K
Merime	K
Meris	K
Merivan	K
Meriyem	K
Mermi	K
Mernur	K
Mernus	K
Mertali	E
Mertay	E
Mertcan	E
Mertullah	E
Merva	K
Mervan	E
Mervane	K
Mervem	K
Mervenur	K
Mervil	K
Merya	K
Meryam	K
Meryemana	K
Meryeme	K
Merzuh	E
Mesdan	E
Mesgule	K
Meshut	E
Mesküre	K
Mesküriye	K
Meslihan	K
Mesni	E
Mesret	E
Mesrule	K
Messud	E
Messut	E
Mesud	E
Mesüde	K
Mesudiye	K
Mesuriye	K
Mesüt	E
Mesuthan	E
Metecan	E
Mettin	E
Meveddet	K
Mevlana	E
Mevlida	K
Mevlidiye	K
Mevliya	K
Mevliye	K
Mevlüd	E
Mevlude	K
Mevlüdiye	K
Mevlut	E
Mevra	K
Mevre	K
Mevriye	K
Mevtun	K
Mevziye	K
Meyase	K
Meydin	E
Meyese	K
Meyhanim	K
Meyhati	E
Meyli	K
Meymene	K
Meyram	K
Meyrem	K
Meyser	K
Mezhar	E
Mezher	E
Miat	E
Michal	E
Midi	E
Mihail	E
Mihdi	E
Mihdiye	K
Mihrab	K
Mihraç	E
Mihraç	K
Mihrap	K
Mihsin	E
Mikail	E
Mikdat	E
Mikolaj	E
Miktat	E
Milay	E
Milayim	E
Milazim	E
Milid	K
Milyel	K
Mimar	E
Minel	K
Minever	K
Minevver	K
Minibe	K
Minire	K
Minnaz	K
Mintaha	K
Minteha	K
Mirac	E
Mirac	K
Mirace	K
Miradiye	K
Miralp	E
Mirbadin	E
Mirbek	E
Mires	K
Mirhasan	E
Miriye	K
Mirsat	E
Mirze	E
Miseyne	K
Mishat	E
Misra	K
Misri	K
Misriye	K
Mistan	E
Mitad	E
Mitat	E
Miyasa	K
Miyaser	K
Miyasi	K
Miyasser	K
Miyese	K
Miyeser	K
Miyesser	K
Mizgin	K
Mizirap	E
Mohammad	E
Möhsim	E
Mola	K
Molla	E
Monika	K
Monis	E
Mualla	K
Muamber	E
Muamer	E
Muazez	K
Muazzen	K
Muazzes	K
Mubarek	E
Muberra	K
Müberrah	K
Müberya	K
Mübetcel	K
Mücade	K
Mücahid	E
Mücahide	K
Mucahit	E
Mücait	E
Mücayit	E
Mücdet	E
Mücella	K
Mücellib	E
Mücelta	K
Mucib	E
Mücibe	K
Mücteba	E
Mücteba	K
Müdavim	E
Müddesir	E
Müeser	K
Müessere	K
Müferra	K
Müfid	E
Mufide	K
Müftah	E
Mugaddes	K
Mügan	K
Mugatter	K
Mügber	K
Muhamet	E
Muhammad	E
Muhammedali	E
Muhammer	E
Muhammeriye	K
Muhammetali	E
Muharem	E
Muhazim	E
Muhbet	E
Muhbet	K
Muhdiye	K
Muhib	E
Muhibe	K
Muhiddin	E
Mühide	K
Muhiye	K
Mühreli	E
Mühside	K
Mühsine	K
Mühteber	K
Muhtereme	K
Muhtesemen	K
Muhubbet	K
Muhubet	K
Muhutdin	E
Muhuttin	E
Muhyedin	E
Muhyettin	E
Muhyiddin	E
Muhyittin	E
Mujde	K
Müjden	K
Müjgan	K
Müjgehan	K
Müjgen	K
Mukaddere	K
Mukaddez	K
Mukader	K
Mukades	K
Mükafat	K
Mükail	E
Mukatder	K
Mukatdes	K
Mukattere	K
Mükayil	E
Mükramin	E
Mukrayil	E
Mükrüme	K
Mülayim	E
Mülcem	E
Mulfer	K
Mülkicihan	K
Mülkinaz	K
Mülkiye	K
Mülkü	E
Mulla	E
Mülüfe	K
Mülüfer	K
Mümesir	K
Mumine	K
Mumtas	E
Mümün	E
Mümüne	K
Münacettin	E
Münadiye	K
Münasiye	K
Müne	K
Münever	K
Münevir	K
Münevvere	K
Münezzer	K
Münib	E
Munife	K
Münik	E
Munip	E
Munir	E
Münircan	E
Münise	K
Müntez	E
Münüp	E
Münür	E
Münüre	K
Munzire	K
Murad	E
Muradiye	K
Muratcan	E
Murathanabdu	E
Mürcan	K
Müret	K
Müreyya	K
Mürfide	K
Mürivvet	K
Mursel	E
Mürselin	E
Mürsid	E
Mursine	K
Mürsüt	E
Mürten	K
Mürteza	E
Mürüfet	K
Mürüvet	K
Murvet	K
Musab	E
Musaburak	E
Musafet	E
Musamettin	E
Müsaret	K
Müseddin	E
Müselahattin	E
Müsemme	K
Müserrefe	K
Müskan	K
Müskünaz	K
Muslu	E
Müslum	E
Müslümet	K
Mustak	E
Mustakiyma	K
Mustan	E
Müstecef	E
Müster	K
Müsüde	K
Müsüre	K
Mutait	E
Mütalip	E
Mutlucan	E
Muttalip	E
Müttezim	K
Mutullah	E
Mutus	E
Müveyla	K
Muzafer	E
Muzafer	K
Müzaffer	E
Muzameddin	E
Müzdelife	K
Müzet	K
Müzeyen	K
Müzeyme	K
Müzüde	K
Nabahat	K
Nabil	E
Nacide	K
Nacifer	K
Nadan	K
Nades	K
Nadiha	K
Nadik	E
Nadile	K
Nadiriye	K
Nafel	E
Nafer	E
Nafier	K
Nafii	E
Nafizenur	K
Nagihan	K
Nahizer	K
Nahsen	E
Naide	K
Naif	E
Naife	K
Naima	K
Najeti	E
Nalan	K
Nalin	K
isimlergül	K
isimlert	E
Namik	E
Namike	K
Namuk	E
Nanifer	K
Narcan	K
Nargehan	K
Narhanim	K
Narhatun	K
Nari	K
Narinç	K
Narmine	K
Nasat	E
Nasiba	K
Nasif	E
Nasihat	K
Nasihe	K
Nasim	E
Nasimi	E
Nasire	K
Nasiybe	K
Nasuf	E
Natalia	K
Natik	E
Natike	K
Navruz	K
Navruze	K
Nayet	K
Naygihan	K
Nayif	E
Nayil	E
Nayile	K
Nayim	E
Nayime	K
Nayliye	K
Nazander	K
Nazangül	K
Nazcan	K
Nazdar	K
Nazefet	K
Nazegül	K
Nazen	K
Nazengül	K
Nazeni	K
Nazente	K
Nazenti	K
Nazez	K
Nazgül	K
Nazgüle	K
Nazi	K
Nazide	K
Nazifer	K
Nazike	K
Naziker	K
Nazile	K
Nazilet	K
Nazim	E
Nazime	K
Nazimet	K
Nazimi	E
Nazira	K
Naziriye	K
Naziye	K
Naziyfe	K
Nazli	E
Nazli	K
Nazlican	K
Nazligül	K
Nazlihan	K
Nazlim	E
Nazlim	K
Nazliye	K
Nazrife	K
Nebat	K
Nebattin	E
Nebia	K
Nebibe	K
Nebide	K
Nebiha	K
Nebihat	K
Necah	K
Necai	E
Necasi	E
Necattin	E
Necbiye	K
Necdat	E
Necet	E
Necibullah	E
Necife	K
Necilal	K
Necim	E
Necima	K
Necime	K
Necip.	E
Neçir	E
Necla	E
Necla	K
Neclat	E
Neclay	K
Necle	K
Necmeddin	E
Necmettin	E
Necmiddin	E
Necmittin	E
Necser	K
Necüde	K
Necva	K
Nedibe	K
Nedife	K
Nedriye	K
Nedve	K
Nedye	K
Nefaret	K
Nefes	K
Nefide	K
Nefiga	K
Nefika	K
Nefire	K
Nefiya	K
Nefiye	K
Nefize	K
Nefya	K
Negihan	K
Negül	K
Nehari	K
Nehide	K
Nehime	K
Nejdat	E
Nejdet	E
Nejdet	K
Nejdi	E
Nejdiye	K
Nejla	K
Nejmettin	E
Nejmi	E
Nejmiye	K
Nelahat	K
Nelda	K
Nelli	K
Nemrun	K
Nerfide	K
Nergahan	K
Nergihan	K
Nergiz	E
Nergiz	K
Nergül	K
Nergün	K
Nergüzel	K
Neriban	K
Neriç	K
Nerkiz	K
Nerman	E
Nerman	K
Nermiye	K
Nerve	K
Nervis	E
Nerzan	K
Nesai	K
Nesfe	K
Nesife	K
Nesih	E
Nesij	E
Nesin	E
Nesirin	K
Neslahan	K
Neslican	K
Neslinur	K
Nesra	K
Nesrihan	K
Nesrim	K
Nesrin	K
Nesriye	K
Netife	K
Nevaf	E
Nevcihan	K
Nevc˜han	E
Nevel	K
Nevgin	K
Nevgün	K
Nevil	K
Nevim	K
Nevise	K
Nevraz	K
Nevrim	K
Nevrize	K
Nevse	K
Nevsi	K
Nevzer	K
Nevzet	E
Nevzete	K
Nevziye	K
Neyfinur	K
Neysen	K
Neytüllah	E
Nezafettin	E
Nezafiye	K
Nezan	K
Nezehat	K
Nezengül	K
Nezif	E
Nezife	K
Neziha	K
Nezihan	K
Nezihat	K
Nezihet	K
Neziye	K
Neziyet	K
Nezize	K
Nezmi	E
Nezrife	K
Nice	K
Nidal	E
Nigar	K
Nige	K
Nigmet	K
Nihari	K
Nihaye	K
Nikar	K
Nikat	K
Nila	K
Nilcan	K
Nilda	K
Nildem	K
Nilden	K
Nilfer	K
Nilgül	K
Nilgun	K
Nilifer	K
Nilsah	K
Nilsen	K
Nilufer	K
Nimetiye	K
Nirgül	K
Nisficihan	K
Nispahi	K
Nisret	E
Niyase	K
Nizameddin	E
Nizgin	K
Nofe	K
Nofel	E
Noman	E
Noran	K
Növfel	E
Nuber	K
Nudet	K
Nudiye	K
Nüdret	K
Nüfer	E
Nüfide	K
Nugman	E
Nuhal	E
Nuhi	E
Nuhiye	K
Nuhtullah	E
Nüket	K
Nükte	K
Nülfer	K
Nülgün	K
Nülifer	K
Nülüfer	K
Nupelda	K
Nura	K
Nurale	K
Nurali	E
Nurane	K
Nuraniye	K
Nurat	K
Nurayan	K
Nurayi	K
Nurbanü	K
Nurberat	K
Nurbetül	K
Nurbolat	E
Nurcay	K
Nurcin	K
Nurda	K
Nurdagül	K
Nurdamla	K
Nurdaniye	K
Nurdanur	K
Nurdeniz	K
Nurdöken	K
Nureddin	E
Nuren	K
Nuretdin	E
Nürettin	E
Nurevsan	K
Nurey	K
Nurfatma	K
Nurfen	K
Nurfet	K
Nurfiye	K
Nurgen	K
Nurgil	K
Nurgüzel	K
Nurhak	K
Nürhan	K
Nurhat	E
Nurhayet	K
Nurhuda	K
Nurhun	K
Nurican	E
Nürice	K
Nuriddin	E
Nurihayat	K
Nurisan	K
Nurisen	K
Nuristan	K
Nuritdin	E
Nurittin	E
Nuriya	K
Nuriyet	K
Nurkadin	K
Nurnisa	K
Nursa	K
Nursan	K
Nursat	K
Nurseda	K
Nürsel	K
Nurselin	K
Nursemi	K
Nursenim	K
Nursevcan	K
Nursever	K
Nurside	K
Nursifa	K
Nursin	E
Nursin	K
Nursiye	K
Nursuman	K
Nürten	K
Nurufe	K
Nurus	K
Nurusah	K
Nurva	K
Nurven	K
Nurya	K
Nurziye	K
Nüset	E
Nüshet	K
Nusrat	E
Nusreddin	E
Nüsret	E
Nusur	E
Nutfiye	K
Nüveyde	K
Nuveyre	K
Nuzret	K
Ny	E
N˜zamett˜n	E
Oana	K
Öbeydullah	E
Ogulkan	E
Oguzhan	E
Oguzorhan	E
Ökkas	E
Olay	E
Olçay	E
Olga	K
Olgacan	E
Olgay	E
Olgu	E
Olgu	K
Olgül	K
Olgun	E
Oliver	E
Olkan	E
Ömercan	E
Ömerul	E
Ömiriye	K
Ömlüye	K
Ömran	E
Ömriye	K
Ömrüm	K
Ömrüye	K
Ömürden	E
Ömürhan	E
Ömüriya	K
Ömürnaz	K
Önday	E
Önder.	E
Önem	E
Önem	K
Onuray	E
Onurcan	E
Orçin	K
Ordunç	E
Orlinda	K
Öskan	E
Östürk	E
Över	E
Özali	E
Ozan.	E
Özaydin	E
Özcem	E
Özde	K
Özdem	K
Özgecan	K
Özgehan	K
Özgenaz	K
Özgenur	K
Özgücan	E
Özgünalp	E
Özkay	E
Özkenan	E
Özlemin	E
Öznür	K
Pakizer	K
Pasa	E
Pasali	E
Pasey	K
Pawel	E
Pehlil	E
Pehlivan	E
Pehlül	E
Pehman	K
Pektas	E
Pelda	K
Pelinsu	K
Pelir	E
Pembesin	K
Pembi	K
Pembis	K
Pempe	K
Penbe	K
Penpe	K
Peral	K
Peray	K
Percihan	K
Perdane	K
Peria	K
Perihannur	K
Perim	K
Perinaz	K
Peris	K
Perisan	K
Perizade	K
Perizan	K
Pernur	K
Pevrül	E
Pevziye	K
Peyami	E
Peyda	K
Peyran	K
Peyruze	K
Piltan	K
Pinar	E
Pinar	K
Piotr	E
Pirahmet	E
Pirhasan	E
Piril	K
Polatkan	E
Pori	K
Przemyslaw	E
Pusat	E
R.	E
Rabbiye	K
Rabiha	K
Rabike	K
Rabiya	K
Rabiye	K
Radim	E
Radiye	K
Rafal	E
Rafig	E
Rafika	K
Rafike	K
Rafiye	K
Ragayip	E
Ragib	E
Ragip	E
Ragup	E
Rahan	K
Rahcan	K
Rahide	K
Raime	K
Rais	E
Raize	K
Rakife	K
Rakite	K
Rakiye	K
Ramadan	E
Rametullah	E
Ramize	K
Ramona	K
Ramziye	K
Raniya	K
Rasan	K
Rasen	K
Rasik	E
Rasike	K
Rasul	E
Ravent	E
Raviye	K
Rayat	E
Rayif	E
Rayim	E
Rayla	K
Raz	K
Razinan	K
Rebihat	K
Rebis	K
Recail	E
Recayi	E
Receb	E
Recepali	E
Recudiye	K
Redda	K
Redife	K
Refa	K
Refahattin	E
Refail	E
Refan	K
Refat	E
Refike	K
Refiya	K
Regaib	E
Rehim	E
Rehime	K
Rekiya	K
Remazan	E
Remezan	E
Remiha	K
Remus	E
Renan	E
Renata	K
Rengül	K
Renin	K
Resalet	K
Resmi	K
Resül	E
Resulcan	E
Revaha	E
Revasiye	K
Revhi	E
Revsi	K
Revzete	K
Reyide	K
Reyis	E
Reyzan	K
Rezge	K
Ridvan	E
Ridvane	K
Rifa	K
Rifki	E
Rihan	K
Rime	K
Riskiye	K
Rivayet	K
Riyad	E
Riyat	E
Riyhane	K
Riza	E
Rizan	E
Rizgar	E
Rizk	E
Rizkiye	K
Rizvan	E
Robert	E
Rohat	E
Rohat	K
Rojbin	K
Rojda	K
Rojdiyar	K
Rojin	K
Rojnu	K
Rolkay	E
Romulus	E
Rosan	K
Rowena	K
Rozan	K
Rozcan	K
Rubasa	K
Rüçan	E
Ruçhan	E
Rufat	E
Rüfet	E
Rufi	E
Rüfiye	K
Rügzan	K
Ruhat	K
Ruhevza	K
Ruhide	K
Ruhser	K
Ruhyete	K
Rüjdiye	K
Ruken	E
Ruken	K
Rukhiya	K
Rukide	K
Rukkiye	K
Ruknettin	E
Rukuya	K
Rüküye	K
Rükye	K
Rumeysa	K
Rumi	E
Rurten	K
Rüsan	E
Rusan	K
Rüsdi	E